NAL,NS,SEMESTRE,NCURSOSMATRICULADOS,NCREDITOSMATRICULADOS,NCREDITOSAPROBADOS,NCREDITOSDESAPROBADOS,PROMEDIOPORCICLO
1,1,2010-1,7,22,12,10,12
1,1,2010-2,7,21,9,12,8
1,1,2010-C,3,11,11,0,15
1,1,2011-1,5,15,3,12,6
1,1,2011-2,5,15,0,15,2
1,1,2011-3,4,12,0,12,0
1,1,2012-1,4,12,0,12,0
1,1,2012-2,5,15,0,15,2
1,1,2013-1,5,15,0,15,3
1,1,2013-2,5,15,3,12,11
1,1,2013-3,4,15,0,15,4
1,1,2014-1,4,15,3,12,5
1,1,2014-2,3,12,0,12,0
1,1,2015-1,3,12,0,12,0
2,2,2010-1,7,22,0,22,0
2,2,2012-2,7,22,18,4,15
2,2,2013-1,6,21,21,0,15
2,2,2013-2,6,18,11,7,13
2,2,2013-3,6,20,16,4,15
2,2,2014-1,6,22,18,4,14
2,2,2014-2,5,19,12,7,14
2,2,2015-1,5,19,11,8,13
2,2,2015-2,5,16,9,7,13
3,3,2010-1,6,21,21,0,15
3,3,2010-2,6,21,14,7,13
3,3,2010-C,3,11,7,4,10
3,3,2011-1,6,21,21,0,15
3,3,2011-2,6,22,14,8,11
3,3,2011-3,6,22,15,7,14
3,3,2012-1,6,22,10,12,9
3,3,2012-2,6,22,15,7,12
3,3,2013-1,6,22,14,8,12
3,3,2013-2,6,22,14,8,13
3,3,2013-3,6,22,8,14,13
3,3,2014-1,6,22,6,16,11
3,3,2014-2,6,22,0,22,10
3,3,2015-1,5,20,4,16,8
4,4,2010-1,6,21,21,0,15
4,4,2010-2,6,21,21,0,15
4,4,2010-C,3,11,7,4,14
4,4,2011-1,6,22,6,16,8
4,4,2011-2,6,22,15,7,12
4,4,2011-3,6,22,0,22,6
4,4,2012-1,6,22,4,18,6
4,4,2012-2,6,22,3,19,6
4,4,2013-1,6,22,10,12,10
4,4,2013-2,5,19,7,12,6
4,4,2013-3,5,20,12,8,13
4,4,2014-1,6,22,22,0,15
4,4,2014-2,6,22,15,7,13
4,4,2015-1,6,22,15,7,13
4,4,2015-2,6,22,18,4,13
5,5,2010-1,6,21,0,21,0
5,5,2011-2,6,21,21,0,16
5,5,2011-3,6,21,21,0,18
5,5,2012-1,7,26,18,8,12
5,5,2012-2,5,20,8,12,10
5,5,2013-1,6,22,18,4,13
5,5,2013-2,6,22,18,4,14
5,5,2013-3,6,22,18,4,13
5,5,2014-1,6,22,19,3,13
5,5,2014-2,6,22,19,3,13
5,5,2015-1,6,22,22,0,15
5,5,2015-2,7,22,20,2,15
6,6,2010-1,7,22,21,1,16
6,6,2010-2,7,22,22,0,16
6,6,2011-1,6,21,21,0,16
6,6,2011-2,6,22,22,0,15
6,6,2011-3,3,12,8,4,15
6,6,2012-1,6,20,17,3,13
6,6,2012-2,7,21,17,4,12
6,6,2013-1,7,20,17,3,15
6,6,2013-2,4,14,11,3,14
6,6,2013-3,7,21,21,0,14
6,6,2014-1,6,22,19,3,15
6,6,2014-2,5,20,20,0,15
7,7,2010-1,7,22,17,5,13
7,7,2010-2,6,19,19,0,15
7,7,2010-C,3,11,7,4,14
7,7,2011-1,6,21,17,4,14
7,7,2011-2,6,22,18,4,13
7,7,2011-3,6,21,5,16,7
7,7,2012-1,6,21,18,3,14
7,7,2012-2,7,22,14,8,12
7,7,2013-1,6,21,21,0,14
7,7,2013-2,6,20,9,11,11
7,7,2013-3,7,22,22,0,14
7,7,2014-1,6,22,10,12,11
7,7,2014-2,6,20,20,0,15
7,7,2015-1,5,22,11,11,12
7,7,2015-2,1,8,8,0,15
8,8,2010-1,7,22,21,1,14
8,8,2010-2,6,22,11,11,10
8,8,2010-C,3,10,7,3,10
8,8,2011-1,7,21,13,8,11
8,8,2011-2,4,16,8,8,14
8,8,2011-3,5,19,12,7,9
8,8,2012-1,5,17,17,0,16
9,9,2010-1,7,22,18,4,14
9,9,2010-2,6,21,21,0,16
9,9,2011-1,6,22,22,0,14
9,9,2011-2,6,22,15,7,13
9,9,2011-3,7,20,11,9,13
9,9,2013-1,7,22,18,4,14
9,9,2013-2,7,22,11,11,13
9,9,2013-3,7,22,21,1,14
9,9,2014-1,7,22,10,12,12
9,9,2014-2,7,22,12,10,13
9,9,2015-1,3,12,4,8,13
10,10,2010-1,6,21,21,0,15
10,10,2010-2,6,21,14,7,11
10,10,2010-C,3,11,7,4,15
10,10,2011-1,6,21,21,0,15
10,10,2011-2,6,22,18,4,14
10,10,2011-3,6,22,11,11,13
10,10,2012-1,6,22,22,0,15
10,10,2012-2,6,22,19,3,14
10,10,2013-1,6,22,22,0,14
10,10,2013-2,6,22,18,4,14
10,10,2013-3,6,22,18,4,14
10,10,2014-1,8,25,21,4,14
10,10,2014-2,1,4,4,0,15
11,11,2010-1,6,21,0,21,0
11,11,2011-1,7,22,0,22,0
11,11,2011-3,6,21,0,21,4
11,11,2012-2,6,21,14,7,11
11,11,2013-1,7,22,7,15,5
11,11,2013-2,6,19,0,19,1
12,12,2010-1,7,22,12,10,13
12,12,2010-2,6,20,17,3,12
12,12,2010-C,2,6,6,0,15
12,12,2011-1,7,22,13,9,11
12,12,2011-2,6,19,10,9,10
12,12,2011-3,6,21,15,6,12
12,12,2012-1,6,19,10,9,10
12,12,2012-2,6,20,14,6,11
12,12,2013-1,6,18,12,6,12
12,12,2013-2,6,19,3,16,7
12,12,2013-3,7,22,10,12,7
12,12,2014-1,7,21,6,15,9
12,12,2014-2,7,21,12,9,11
12,12,2015-1,6,18,6,12,7
12,12,2015-2,7,22,6,16,4
13,13,2010-1,6,21,21,0,16
13,13,2010-2,6,21,18,3,16
13,13,2011-1,6,22,22,0,16
13,13,2011-2,6,22,22,0,15
13,13,2011-3,6,22,22,0,15
13,13,2012-1,6,21,18,3,14
13,13,2012-2,6,22,22,0,15
13,13,2013-1,6,22,22,0,15
13,13,2013-2,6,22,22,0,16
13,13,2013-3,7,21,21,0,14
13,13,2014-1,2,6,6,0,16
14,14,2010-1,7,22,13,9,11
14,14,2010-2,7,22,18,4,14
14,14,2010-C,2,6,6,0,15
14,14,2011-1,6,18,12,6,12
14,14,2011-2,6,20,3,17,7
14,14,2011-3,6,20,6,14,7
14,14,2012-1,6,22,19,3,13
14,14,2012-2,4,14,3,11,3
14,14,2013-1,3,12,4,8,13
14,14,2013-2,4,16,8,8,12
14,14,2013-3,5,18,4,14,11
14,14,2014-1,5,18,3,15,5
14,14,2014-2,4,15,4,11,6
14,14,2015-2,6,20,0,20,1
15,15,2010-1,8,21,0,21,0
15,15,2011-3,8,21,13,8,9
15,15,2012-2,7,22,6,16,7
15,15,2013-1,7,19,0,19,2
15,15,2013-2,7,19,11,8,10
15,15,2013-3,6,18,10,8,11
15,15,2014-1,7,25,0,25,4
15,15,2014-2,7,25,9,16,6
16,16,2010-1,6,20,20,0,17
16,16,2010-2,6,22,18,4,15
16,16,2010-C,4,11,11,0,18
16,16,2011-1,7,21,17,4,13
16,16,2011-2,7,21,13,8,11
16,16,2011-3,7,22,11,11,13
16,16,2012-1,5,20,20,0,15
16,16,2012-2,7,22,12,10,13
16,16,2013-2,7,22,18,4,15
16,16,2013-3,6,22,22,0,15
16,16,2014-1,5,20,9,11,13
16,16,2014-2,1,8,8,0,17
17,17,2010-1,7,22,0,22,0
17,17,2011-1,7,22,5,17,9
18,18,2010-1,7,22,17,5,14
18,18,2010-2,7,22,10,12,9
18,18,2011-1,6,20,7,13,11
18,18,2011-2,6,21,12,9,13
18,18,2011-3,6,20,11,9,13
18,18,2012-1,6,21,17,4,13
18,18,2012-2,6,22,14,8,11
18,18,2013-1,8,22,21,1,14
18,18,2013-2,8,22,4,18,10
18,18,2013-3,8,22,17,5,13
18,18,2014-1,7,20,4,16,10
18,18,2014-2,7,21,7,14,11
18,18,2015-1,7,21,14,7,12
18,18,2015-2,6,21,15,6,14
19,19,2010-1,6,21,0,21,0
20,20,2010-1,7,22,22,0,15
20,20,2010-2,7,22,19,3,13
20,20,2011-1,6,19,0,19,7
20,20,2011-2,7,22,3,19,4
20,20,2011-3,7,22,0,22,5
22,22,2010-1,4,14,0,14,0
23,23,2010-1,6,21,21,0,16
23,23,2010-2,6,21,21,0,15
23,23,2011-1,6,22,22,0,16
23,23,2011-2,6,22,22,0,14
23,23,2011-3,6,22,22,0,14
23,23,2012-1,6,21,21,0,15
23,23,2012-2,6,22,22,0,16
23,23,2013-1,6,22,22,0,17
23,23,2013-2,6,22,18,4,15
23,23,2013-3,6,19,19,0,15
23,23,2014-1,2,6,6,0,15
24,24,2010-1,7,22,0,22,0
25,25,2010-1,6,21,21,0,15
25,25,2010-2,6,22,22,0,15
25,25,2010-C,3,11,11,0,16
25,25,2011-1,6,22,18,4,14
25,25,2011-2,6,22,18,4,15
25,25,2011-3,6,22,15,7,13
25,25,2012-1,6,22,22,0,14
25,25,2012-2,6,22,0,22,3
25,25,2013-1,6,22,18,4,14
25,25,2013-2,6,22,14,8,13
25,25,2013-3,6,22,11,11,11
25,25,2014-1,6,22,14,8,13
25,25,2014-2,6,20,20,0,14
25,25,2015-1,4,12,12,0,14
26,26,2010-1,4,14,6,8,7
26,26,2010-2,6,21,6,15,8
26,26,2011-1,6,22,7,15,5
26,26,2011-2,5,19,3,16,4
26,26,2011-3,4,16,8,8,12
26,26,2012-1,5,20,0,20,7
26,26,2012-2,6,22,7,15,8
26,26,2013-1,7,22,9,13,10
26,26,2013-2,6,22,18,4,14
26,26,2013-3,7,22,0,22,6
26,26,2014-1,6,21,9,12,10
26,26,2014-2,6,22,7,15,11
26,26,2015-1,7,20,5,15,6
26,26,2015-2,5,14,3,11,10
27,27,2010-1,3,11,4,7,13
27,27,2010-2,6,21,21,0,15
27,27,2010-C,3,11,11,0,15
27,27,2011-1,6,22,12,10,8
27,27,2011-2,6,22,18,4,15
27,27,2011-3,6,22,15,7,14
28,28,2010-1,6,21,14,7,13
28,28,2010-2,6,22,11,11,12
28,28,2010-C,2,7,7,0,15
28,28,2011-1,6,22,4,18,10
28,28,2011-2,6,22,11,11,9
28,28,2011-3,6,22,0,22,3
28,28,2012-1,6,22,0,22,0
28,28,2012-2,6,22,0,22,3
28,28,2013-1,6,22,3,19,4
28,28,2013-2,6,22,0,22,4
29,29,2010-1,6,21,17,4,12
29,29,2013-1,6,21,13,8,11
29,29,2013-2,5,17,10,7,14
29,29,2013-3,5,15,15,0,14
29,29,2014-1,3,11,11,0,15
29,29,2014-2,5,19,15,4,13
29,29,2015-1,5,20,20,0,15
29,29,2015-2,6,20,20,0,15
30,30,2010-1,6,21,6,15,7
30,30,2010-2,7,22,0,22,0
30,30,2010-C,3,11,4,7,5
30,30,2011-1,7,22,0,22,3
30,30,2011-2,7,22,3,19,7
30,30,2012-1,5,18,7,11,12
30,30,2012-2,6,19,15,4,14
30,30,2013-1,6,21,17,4,12
30,30,2013-2,6,22,19,3,14
30,30,2013-3,6,20,12,8,10
30,30,2014-1,6,22,3,19,8
30,30,2014-2,5,20,8,12,10
30,30,2015-1,7,21,12,9,9
30,30,2015-2,7,19,3,16,4
31,31,2010-1,6,21,13,8,12
31,31,2010-2,6,21,17,4,14
31,31,2010-C,3,11,4,7,10
31,31,2011-1,6,21,8,13,11
31,31,2011-2,6,21,13,8,13
31,31,2011-3,6,21,13,8,9
31,31,2012-1,6,22,15,7,13
31,31,2012-2,6,20,3,17,11
31,31,2013-1,7,21,14,7,13
31,31,2013-2,7,22,5,17,8
31,31,2014-1,7,22,19,3,13
31,31,2014-2,6,20,14,6,15
31,31,2015-1,7,20,10,10,11
31,31,2015-2,7,22,8,14,8
32,32,2010-1,7,22,22,0,18
32,32,2010-2,7,22,22,0,17
32,32,2010-C,3,9,9,0,18
32,32,2011-1,8,25,25,0,17
32,32,2011-2,3,10,10,0,19
32,32,2011-3,4,17,17,0,17
32,32,2012-1,7,22,22,0,18
32,32,2012-2,7,22,22,0,18
32,32,2013-1,7,22,22,0,17
32,32,2013-2,7,22,22,0,17
32,32,2013-3,7,22,22,0,17
33,33,2010-1,6,21,17,4,13
33,33,2010-2,7,21,17,4,14
33,33,2010-C,3,11,7,4,14
33,33,2011-1,6,20,16,4,14
33,33,2011-2,5,20,12,8,12
33,33,2011-3,6,22,7,15,10
33,33,2012-1,6,22,12,10,13
33,33,2012-2,7,22,15,7,12
33,33,2013-1,6,20,7,13,8
33,33,2013-3,4,12,0,12,6
33,33,2014-1,6,21,9,12,9
33,33,2014-2,6,19,3,16,6
33,33,2015-1,5,18,6,12,10
33,33,2015-2,6,22,14,8,13
34,34,2010-1,6,21,13,8,10
34,34,2010-2,7,22,0,22,0
34,34,2013-1,6,18,13,5,14
34,34,2013-2,6,22,0,22,4
34,34,2013-3,6,20,20,0,15
34,34,2014-1,6,19,8,11,10
34,34,2014-2,5,19,0,19,2
34,34,2015-1,6,19,4,15,9
34,34,2015-2,5,15,10,5,14
35,35,2010-1,7,22,16,6,15
35,35,2010-2,7,22,15,7,12
35,35,2010-C,1,4,0,4,9
35,35,2011-1,5,16,0,16,0
35,35,2011-2,5,16,0,16,4
35,35,2011-3,5,16,3,13,5
36,36,2010-1,7,22,0,22,1
36,36,2010-2,7,22,0,22,6
36,36,2011-1,7,22,10,12,10
36,36,2011-2,7,21,7,14,9
36,36,2011-3,6,20,9,11,11
36,36,2012-1,4,14,11,3,14
36,36,2012-2,5,17,6,11,10
36,36,2013-1,5,16,12,4,14
36,36,2013-2,6,21,0,21,5
36,36,2013-3,6,22,4,18,6
36,36,2014-1,5,19,7,12,10
36,36,2014-2,5,19,3,16,8
36,36,2015-1,4,16,8,8,14
36,36,2015-2,5,20,12,8,11
37,37,2010-1,7,22,22,0,15
37,37,2010-2,7,22,19,3,13
37,37,2011-1,7,22,19,3,12
37,37,2011-2,7,22,7,15,6
37,37,2011-3,7,22,0,22,3
37,37,2012-2,6,21,0,21,6
37,37,2014-2,6,20,12,8,10
37,37,2015-1,5,19,8,11,8
38,38,2010-1,7,22,22,0,16
38,38,2010-2,7,22,22,0,17
38,38,2011-1,7,22,22,0,16
38,38,2011-2,6,22,14,8,15
38,38,2011-3,5,20,16,4,15
38,38,2012-1,4,14,14,0,16
38,38,2012-2,6,22,22,0,16
38,38,2013-1,6,22,22,0,17
38,38,2013-2,6,22,22,0,16
38,38,2013-3,6,22,22,0,16
38,38,2014-1,6,19,19,0,17
39,39,2010-1,6,21,7,14,10
39,39,2010-2,6,21,14,7,12
39,39,2010-C,2,7,0,7,0
39,39,2011-1,6,21,11,10,10
39,39,2011-2,5,17,14,3,13
39,39,2011-3,6,21,14,7,11
39,39,2012-1,6,21,14,7,13
39,39,2012-2,6,22,18,4,14
39,39,2013-1,6,22,22,0,15
39,39,2013-2,6,22,18,4,15
39,39,2013-3,6,22,22,0,14
39,39,2014-1,6,22,18,4,15
39,39,2014-2,6,22,18,4,15
39,39,2015-1,8,26,26,0,15
40,40,2010-1,6,21,3,18,4
41,41,2010-1,7,22,18,4,14
41,41,2010-2,6,22,14,8,13
41,41,2010-C,3,11,11,0,14
41,41,2011-1,6,21,13,8,13
41,41,2011-2,6,22,11,11,9
41,41,2011-3,6,21,4,17,11
41,41,2012-1,6,22,10,12,11
41,41,2013-1,7,22,6,16,12
41,41,2013-2,6,20,8,12,10
41,41,2013-3,6,22,14,8,12
41,41,2014-1,7,22,14,8,12
41,41,2014-2,6,21,3,18,10
41,41,2015-1,6,22,11,11,12
41,41,2015-2,7,21,6,15,11
42,42,2010-1,7,22,22,0,15
42,42,2010-2,7,22,22,0,15
42,42,2011-1,4,14,14,0,15
42,42,2011-2,4,12,12,0,16
42,42,2011-3,4,14,10,4,14
42,42,2012-1,4,15,15,0,16
42,42,2012-2,4,15,15,0,17
42,42,2013-1,4,15,15,0,15
42,42,2013-2,4,14,11,3,15
42,42,2013-3,4,15,11,4,13
43,43,2010-1,6,21,17,4,13
43,43,2010-2,6,22,11,11,11
43,43,2010-C,3,12,4,8,10
43,43,2011-1,6,21,10,11,12
43,43,2011-2,7,22,13,9,12
43,43,2011-3,7,22,10,12,9
43,43,2012-1,6,22,15,7,14
43,43,2012-2,6,22,19,3,14
43,43,2013-1,6,22,6,16,11
43,43,2013-2,5,19,0,19,4
43,43,2013-3,5,20,4,16,7
43,43,2014-1,6,22,4,18,6
43,43,2014-2,5,20,0,20,1
43,43,2015-1,6,22,0,22,1
43,43,2015-2,5,16,0,16,0
44,44,2010-1,6,21,9,12,10
44,44,2010-2,6,22,7,15,8
44,44,2010-C,3,11,11,0,14
44,44,2011-1,7,22,4,18,11
44,44,2011-2,7,22,12,10,12
44,44,2011-3,6,20,15,5,14
44,44,2012-1,7,20,14,6,13
44,44,2012-2,8,22,6,16,9
44,44,2013-1,6,21,10,11,11
44,44,2013-2,6,19,10,9,10
44,44,2015-1,6,19,10,9,14
44,44,2015-2,8,21,20,1,14
45,45,2010-1,7,22,4,18,4
45,45,2013-1,7,21,5,16,10
45,45,2013-2,6,21,0,21,2
45,45,2013-3,5,17,17,0,15
45,45,2014-1,6,19,19,0,15
45,45,2014-2,5,18,14,4,15
45,45,2015-1,5,20,20,0,16
45,45,2015-2,4,15,15,0,16
46,46,2010-1,6,21,21,0,16
46,46,2010-2,6,19,19,0,17
46,46,2010-C,3,12,12,0,17
46,46,2011-2,5,20,20,0,16
46,46,2011-3,6,22,18,4,16
46,46,2012-1,6,20,20,0,18
46,46,2012-2,3,10,10,0,18
46,46,2013-1,3,11,11,0,17
47,47,2010-1,6,21,18,3,13
47,47,2010-2,4,13,0,13,0
48,48,2010-1,7,22,20,2,14
48,48,2010-2,7,22,15,7,14
48,48,2010-C,2,6,6,0,16
48,48,2011-1,7,22,22,0,16
48,48,2011-2,6,21,21,0,16
48,48,2011-3,6,22,22,0,17
48,48,2012-1,6,22,19,3,14
48,48,2012-2,6,22,18,4,15
48,48,2013-1,6,21,17,4,14
48,48,2013-2,5,19,19,0,16
48,48,2013-3,5,20,16,4,14
48,48,2014-1,7,22,18,4,14
48,48,2014-2,1,4,0,4,6
48,48,2015-1,1,4,4,0,14
49,49,2010-1,7,22,22,0,15
49,49,2010-2,7,22,19,3,15
49,49,2011-1,7,22,22,0,15
49,49,2011-2,6,21,18,3,15
49,49,2011-3,6,21,21,0,16
49,49,2012-1,5,19,19,0,15
49,49,2012-2,6,22,22,0,16
49,49,2013-1,6,22,19,3,15
49,49,2013-2,3,11,11,0,16
49,49,2013-3,5,18,14,4,14
49,49,2014-1,6,22,19,3,14
49,49,2014-2,4,11,11,0,17
51,51,2010-1,7,22,22,0,18
51,51,2010-2,5,16,16,0,17
51,51,2010-C,3,9,9,0,15
51,51,2011-1,7,23,23,0,17
51,51,2011-2,6,22,22,0,17
51,51,2011-3,7,26,26,0,17
51,51,2012-1,6,22,22,0,16
51,51,2012-2,6,21,21,0,16
51,51,2013-1,5,19,15,4,13
51,51,2013-2,4,16,16,0,16
51,51,2013-3,5,15,15,0,16
51,51,2014-1,3,10,10,0,17
52,52,2010-1,7,22,18,4,15
52,52,2010-2,6,19,16,3,15
52,52,2010-C,3,10,10,0,16
52,52,2011-1,6,21,17,4,13
52,52,2011-2,6,21,21,0,17
52,52,2011-3,6,21,18,3,16
52,52,2012-1,6,22,19,3,16
52,52,2012-2,6,20,16,4,15
52,52,2013-1,6,22,22,0,15
52,52,2013-2,6,22,19,3,16
52,52,2013-3,6,22,22,0,15
52,52,2014-1,6,19,19,0,17
53,53,2010-1,7,22,22,0,15
53,53,2010-2,7,22,18,4,11
53,53,2010-C,3,11,11,0,15
53,53,2011-1,6,19,19,0,16
53,53,2011-2,6,22,19,3,14
53,53,2011-3,6,20,20,0,16
53,53,2012-1,6,22,22,0,16
53,53,2012-2,6,22,22,0,16
53,53,2013-1,4,15,15,0,17
53,53,2013-2,6,22,22,0,16
53,53,2013-3,6,20,20,0,16
53,53,2014-1,2,7,7,0,18
54,54,2010-1,7,22,22,0,15
54,54,2010-2,7,22,18,4,11
54,54,2010-C,3,11,11,0,15
54,54,2011-1,6,19,19,0,16
54,54,2011-2,6,22,19,3,14
54,54,2011-3,6,20,20,0,16
54,54,2012-1,6,22,22,0,16
54,54,2012-2,6,22,22,0,16
54,54,2013-1,4,15,15,0,17
54,54,2013-2,6,22,22,0,16
54,54,2013-3,6,20,20,0,16
54,54,2014-1,2,7,7,0,19
55,55,2010-1,7,22,16,6,14
55,55,2010-2,7,21,17,4,14
55,55,2010-C,3,10,10,0,14
55,55,2011-1,6,20,17,3,13
55,55,2011-2,6,21,10,11,11
55,55,2011-3,6,21,18,3,13
55,55,2012-1,5,19,15,4,15
55,55,2012-2,6,23,19,4,14
55,55,2013-1,8,30,30,0,16
55,55,2013-2,4,15,15,0,14
55,55,2013-3,6,21,21,0,15
55,55,2014-1,5,16,16,0,16
55,55,2015-2,2,6,6,0,16
56,56,2010-1,7,22,22,0,16
56,56,2010-2,7,22,22,0,15
56,56,2011-1,7,22,22,0,15
56,56,2011-2,6,22,18,4,15
56,56,2011-3,5,19,19,0,16
56,56,2012-1,5,19,19,0,17
56,56,2012-2,6,21,21,0,16
56,56,2013-1,6,21,21,0,15
56,56,2013-2,4,15,12,3,15
56,56,2013-3,6,22,22,0,16
56,56,2014-1,6,19,19,0,17
57,57,2010-1,6,21,17,4,13
57,57,2010-2,4,14,14,0,15
57,57,2010-C,3,11,7,4,14
58,58,2010-1,6,21,13,8,12
58,58,2010-2,4,15,11,4,11
58,58,2010-C,2,7,3,4,12
58,58,2011-1,6,21,17,4,14
58,58,2011-2,4,15,8,7,11
58,58,2012-2,4,15,3,12,7
59,59,2010-1,6,21,17,4,12
60,60,2010-1,6,21,0,21,0
60,60,2011-1,6,21,3,18,2
61,61,2010-1,6,21,9,12,12
61,61,2010-2,6,21,18,3,14
61,61,2011-1,6,21,13,8,13
61,61,2011-2,6,22,14,8,10
61,61,2011-3,6,22,3,19,3
61,61,2012-2,5,19,0,19,4
61,61,2014-1,6,18,0,18,1
61,61,2014-2,5,15,4,11,7
62,62,2010-1,6,21,21,0,14
62,62,2010-2,6,22,10,12,12
62,62,2010-C,3,11,11,0,16
62,62,2011-1,6,22,14,8,12
62,62,2011-2,6,21,17,4,14
62,62,2011-3,5,20,20,0,16
62,62,2012-1,5,19,19,0,15
62,62,2012-2,6,21,18,3,15
62,62,2013-1,6,22,22,0,15
62,62,2013-3,5,19,8,11,11
62,62,2014-1,4,14,0,14,2
62,62,2014-2,5,18,7,11,13
64,64,2010-1,6,21,3,18,2
65,65,2010-1,6,21,9,12,13
65,65,2010-2,6,21,17,4,14
65,65,2011-1,6,21,14,7,11
65,65,2011-2,6,22,14,8,12
65,65,2011-3,6,22,11,11,10
65,65,2012-1,6,22,15,7,14
65,65,2012-2,6,22,18,4,13
65,65,2013-1,3,12,12,0,15
65,65,2013-2,6,21,21,0,15
65,65,2013-3,6,22,22,0,16
65,65,2014-1,6,22,22,0,15
65,65,2014-2,6,22,18,4,13
65,65,2015-1,7,23,23,0,15
66,66,2010-1,6,21,17,4,13
66,66,2010-2,6,21,10,11,14
66,66,2011-1,6,20,12,8,13
66,66,2011-2,6,19,18,1,14
66,66,2011-3,7,22,12,10,13
66,66,2012-1,7,20,20,0,15
66,66,2012-2,6,22,11,11,12
66,66,2013-1,7,22,22,0,14
66,66,2013-2,7,22,19,3,13
66,66,2013-3,7,21,21,0,15
66,66,2014-1,6,22,22,0,15
66,66,2015-1,6,20,20,0,15
66,66,2015-2,3,12,12,0,14
67,67,2010-1,6,21,17,4,13
67,67,2010-2,6,21,17,4,15
67,67,2011-1,6,21,21,0,16
67,67,2011-2,6,22,22,0,16
67,67,2011-3,7,22,21,1,15
67,67,2012-1,7,21,18,3,14
67,67,2012-2,7,21,17,4,14
67,67,2013-1,7,22,22,0,15
67,67,2013-2,7,22,22,0,15
67,67,2013-3,6,22,18,4,15
67,67,2014-1,5,21,21,0,14
68,68,2010-1,6,21,6,15,6
69,69,2010-1,6,21,0,21,3
69,69,2010-2,7,22,3,19,2
69,69,2013-1,6,21,6,15,9
69,69,2013-2,4,14,6,8,10
69,69,2013-3,4,15,7,8,10
69,69,2014-1,6,20,16,4,13
69,69,2014-2,6,19,12,7,12
69,69,2015-1,5,19,4,15,9
69,69,2015-2,5,19,7,12,10
70,70,2010-1,6,21,6,15,7
70,70,2010-2,7,22,3,19,6
70,70,2010-C,3,11,4,7,7
70,70,2011-3,6,19,3,16,6
71,71,2010-1,7,22,17,5,14
71,71,2010-2,6,22,0,22,7
71,71,2010-C,3,11,11,0,15
71,71,2011-1,6,22,10,12,10
71,71,2011-2,6,18,8,10,9
71,71,2011-3,4,13,0,13,8
71,71,2012-1,5,14,9,5,13
71,71,2012-2,6,20,13,7,11
71,71,2013-1,5,17,17,0,14
71,71,2013-2,6,22,18,4,14
71,71,2013-3,8,22,15,7,13
71,71,2014-1,6,20,16,4,13
71,71,2014-2,6,21,17,4,14
71,71,2015-1,7,22,14,8,14
71,71,2015-2,6,22,10,12,14
72,72,2010-2,6,21,21,0,18
72,72,2010-C,3,11,11,0,18
72,72,2011-1,7,25,25,0,18
72,72,2011-2,8,26,26,0,17
72,72,2011-3,8,25,25,0,17
72,72,2012-1,7,23,23,0,17
72,72,2012-2,8,26,26,0,17
72,72,2013-1,7,22,22,0,17
72,72,2013-2,5,15,15,0,16
72,72,2013-3,5,22,22,0,18
73,73,2010-1,6,21,6,15,9
73,73,2010-2,6,21,17,4,14
73,73,2010-C,3,11,11,0,14
73,73,2011-1,6,20,12,8,13
73,73,2011-2,6,22,22,0,15
73,73,2011-3,6,22,14,8,11
73,73,2012-1,8,22,22,0,15
73,73,2012-2,6,22,15,7,14
73,73,2013-1,7,22,19,3,15
73,73,2013-2,7,22,22,0,14
73,73,2013-3,6,21,17,4,14
73,73,2014-1,6,21,21,0,15
73,73,2014-2,6,24,24,0,15
75,75,2010-2,7,22,18,4,11
75,75,2011-1,7,22,11,11,13
75,75,2011-2,6,19,7,12,10
75,75,2011-3,4,14,10,4,12
75,75,2012-1,6,20,9,11,12
75,75,2012-2,4,13,6,7,12
75,75,2013-1,4,15,4,11,11
75,75,2013-2,4,14,11,3,14
75,75,2013-3,5,19,4,15,9
75,75,2014-1,5,19,3,16,11
75,75,2014-2,4,16,8,8,13
75,75,2015-1,6,20,16,4,13
75,75,2015-2,5,19,11,8,10
76,76,2010-1,7,22,18,4,14
76,76,2010-2,7,22,18,4,13
76,76,2010-C,1,4,4,0,15
76,76,2011-1,5,15,15,0,15
76,76,2011-2,6,21,14,7,13
76,76,2011-3,6,22,15,7,12
76,76,2012-1,5,19,11,8,11
76,76,2012-2,4,15,12,3,14
76,76,2013-1,6,21,18,3,16
76,76,2013-2,6,22,15,7,15
76,76,2013-3,6,21,17,4,13
76,76,2014-1,6,22,11,11,12
76,76,2014-2,4,16,16,0,15
76,76,2015-1,5,18,18,0,15
76,76,2015-2,5,15,15,0,15
77,77,2010-1,7,22,14,8,12
77,77,2010-2,6,19,8,11,9
77,77,2010-C,3,11,7,4,12
77,77,2011-1,4,13,11,2,13
77,77,2011-3,3,12,8,4,13
77,77,2012-1,3,9,9,0,15
77,77,2012-2,5,17,14,3,13
77,77,2013-1,4,14,14,0,16
77,77,2013-2,4,15,15,0,14
77,77,2013-3,6,22,22,0,14
77,77,2014-1,6,21,21,0,15
77,77,2014-2,6,22,14,8,12
77,77,2015-1,5,19,19,0,16
77,77,2015-2,5,20,12,8,13
78,78,2010-1,7,22,22,0,15
78,78,2010-2,7,22,22,0,15
78,78,2011-1,4,13,0,13,3
78,78,2012-1,4,13,13,0,16
78,78,2013-1,3,9,6,3,10
79,79,2010-1,7,22,12,10,12
79,79,2010-2,4,12,2,10,5
79,79,2010-C,2,7,3,4,9
79,79,2011-1,5,16,7,9,11
80,80,2010-1,7,22,14,8,12
80,80,2010-2,6,19,5,14,9
80,80,2010-C,3,11,0,11,3
80,80,2011-1,4,14,7,7,10
81,81,2010-1,7,22,14,8,13
81,81,2010-2,5,16,16,0,15
81,81,2010-C,3,11,3,8,9
81,81,2011-1,6,19,17,2,14
81,81,2011-2,6,19,13,6,11
81,81,2011-3,6,22,14,8,11
81,81,2012-1,5,19,19,0,14
81,81,2012-2,6,21,21,0,15
81,81,2013-1,6,22,18,4,15
81,81,2013-2,6,22,22,0,15
81,81,2013-3,6,22,18,4,13
81,81,2014-1,5,19,19,0,15
81,81,2014-2,4,14,14,0,16
81,81,2015-1,3,9,9,0,16
83,83,2010-1,7,22,12,10,13
83,83,2010-2,6,20,17,3,14
83,83,2011-1,7,22,19,3,15
83,83,2011-2,7,22,9,13,9
83,83,2011-3,6,19,3,16,4
83,83,2012-2,5,16,9,7,12
83,83,2013-1,5,15,15,0,16
83,83,2013-2,4,15,15,0,17
83,83,2013-3,7,24,24,0,15
83,83,2014-1,4,13,10,3,14
83,83,2014-2,7,22,22,0,16
83,83,2015-1,7,22,22,0,16
83,83,2015-2,7,22,22,0,16
84,84,2010-1,7,22,22,0,15
85,85,2010-1,7,22,17,5,15
85,85,2010-2,7,21,4,17,4
85,85,2010-C,3,9,6,3,14
86,86,2010-1,7,22,16,6,14
86,86,2010-2,7,22,13,9,13
86,86,2010-C,3,9,9,0,15
86,86,2011-1,7,22,13,9,11
86,86,2011-2,7,22,4,18,10
86,86,2012-1,6,20,11,9,11
86,86,2012-2,6,19,16,3,14
86,86,2013-1,5,16,13,3,16
86,86,2013-2,6,21,15,6,15
86,86,2013-3,5,15,15,0,16
86,86,2014-1,7,21,15,6,15
86,86,2014-2,6,19,12,7,12
86,86,2015-1,6,19,12,7,11
86,86,2015-2,7,22,15,7,12
87,87,2010-1,7,22,22,0,15
87,87,2010-2,7,22,22,0,14
87,87,2010-C,4,12,9,3,11
87,87,2011-1,7,22,10,12,12
87,87,2011-2,7,22,19,3,14
87,87,2011-3,6,22,8,14,13
87,87,2012-1,6,21,18,3,14
87,87,2012-2,6,20,17,3,15
87,87,2013-1,7,22,15,7,12
87,87,2013-2,7,22,7,15,10
87,87,2013-3,6,19,6,13,10
87,87,2014-1,6,19,16,3,13
87,87,2014-2,6,19,10,9,13
87,87,2015-1,6,18,18,0,16
87,87,2015-2,6,18,15,3,14
88,88,2010-1,7,22,22,0,16
88,88,2010-2,7,22,22,0,15
88,88,2010-C,3,9,9,0,16
88,88,2011-1,7,22,22,0,16
88,88,2011-2,4,13,13,0,16
88,88,2011-3,5,20,20,0,17
88,88,2012-1,7,22,22,0,16
88,88,2012-2,7,22,22,0,16
88,88,2013-1,7,22,22,0,16
88,88,2013-2,7,22,22,0,16
88,88,2013-3,6,19,19,0,16
89,89,2010-1,7,22,22,0,17
89,89,2010-2,7,22,22,0,15
90,90,2010-1,7,22,22,0,15
90,90,2010-2,7,22,16,6,12
90,90,2010-C,3,9,3,6,5
90,90,2011-1,7,22,16,6,14
90,90,2011-2,7,22,13,9,13
90,90,2011-3,6,21,7,14,6
90,90,2012-1,6,20,3,17,7
90,90,2012-2,3,11,3,8,4
90,90,2014-1,5,18,8,10,7
90,90,2014-2,7,22,16,6,12
90,90,2015-1,5,15,15,0,15
90,90,2015-2,7,22,18,4,15
91,91,2010-1,7,22,22,0,14
91,91,2010-2,7,22,18,4,14
91,91,2010-C,3,9,6,3,13
91,91,2011-1,7,22,12,10,11
91,91,2011-2,7,22,9,13,11
91,91,2011-3,6,21,15,6,14
91,91,2012-1,6,19,9,10,12
91,91,2012-2,6,19,19,0,16
91,91,2013-1,6,19,16,3,14
91,91,2013-2,6,21,18,3,13
91,91,2013-3,4,13,7,6,11
91,91,2014-1,7,22,19,3,13
91,91,2014-2,7,22,3,19,5
91,91,2015-1,6,19,0,19,2
91,91,2015-2,7,22,4,18,6
92,92,2010-1,7,22,22,0,16
92,92,2010-2,7,22,22,0,15
92,92,2010-C,2,6,6,0,15
92,92,2011-1,7,22,22,0,15
92,92,2011-2,5,16,6,10,13
92,92,2011-3,6,22,18,4,14
92,92,2012-1,6,21,17,4,15
92,92,2012-2,5,16,16,0,15
92,92,2013-1,4,13,10,3,14
92,92,2013-2,7,22,22,0,14
92,92,2013-3,7,22,22,0,14
92,92,2014-1,6,19,19,0,15
92,92,2014-2,4,13,10,3,14
92,92,2015-1,1,3,3,0,14
93,93,2010-1,7,22,22,0,16
93,93,2010-2,7,22,22,0,15
93,93,2010-C,3,9,9,0,17
93,93,2011-1,7,22,19,3,14
93,93,2011-2,5,16,13,3,14
93,93,2011-3,5,19,19,0,15
93,93,2012-1,6,20,10,10,12
93,93,2012-2,7,22,22,0,15
93,93,2013-1,7,22,19,3,14
93,93,2013-2,7,22,22,0,15
93,93,2013-3,6,19,13,6,14
93,93,2014-1,6,19,19,0,16
93,93,2014-2,2,6,6,0,15
94,94,2010-1,7,22,22,0,16
94,94,2010-2,7,22,22,0,15
94,94,2011-1,7,22,19,3,14
94,94,2011-2,7,22,16,6,12
94,94,2011-3,6,21,11,10,10
94,94,2012-1,6,22,22,0,14
94,94,2012-2,7,22,12,10,9
94,94,2013-1,4,12,9,3,12
94,94,2013-2,7,22,0,22,2
94,94,2013-3,7,21,0,21,4
94,94,2014-1,6,19,7,12,7
94,94,2014-2,4,12,3,9,7
94,94,2015-1,7,22,4,18,8
95,95,2010-1,6,21,17,4,12
95,95,2010-2,6,21,3,18,8
95,95,2011-1,6,21,7,14,9
96,96,2010-1,6,21,17,4,14
96,96,2012-1,6,21,7,14,7
96,96,2013-3,4,14,7,7,8
96,96,2014-1,5,15,15,0,15
96,96,2014-2,5,17,13,4,14
96,96,2015-1,4,16,16,0,15
96,96,2015-2,5,18,14,4,13
97,97,2010-1,6,21,0,21,0
98,98,2010-1,6,21,21,0,14
98,98,2010-2,6,22,22,0,16
98,98,2010-C,3,11,11,0,16
98,98,2011-1,6,22,22,0,15
98,98,2011-2,6,22,22,0,14
98,98,2011-3,6,21,18,3,14
98,98,2012-1,6,22,22,0,15
98,98,2012-2,6,22,22,0,15
98,98,2013-1,6,22,22,0,15
98,98,2013-2,7,22,22,0,15
98,98,2013-3,4,12,12,0,15
100,100,2010-1,6,21,14,7,13
101,101,2010-1,6,21,14,7,13
101,101,2011-2,6,21,14,7,13
101,101,2011-3,6,22,8,14,11
101,101,2012-1,7,22,19,3,14
101,101,2012-2,4,15,0,15,8
101,101,2015-1,6,22,12,10,12
101,101,2015-2,6,19,15,4,14
102,102,2010-1,6,21,21,0,15
102,102,2010-2,6,21,21,0,16
102,102,2010-C,3,11,7,4,14
102,102,2011-1,6,22,22,0,15
102,102,2011-2,6,22,19,3,13
102,102,2011-3,6,22,22,0,15
102,102,2012-1,6,22,22,0,15
102,102,2012-2,6,22,19,3,13
102,102,2013-1,6,22,22,0,15
102,102,2013-2,7,22,22,0,15
102,102,2013-3,6,19,19,0,15
103,103,2010-1,6,21,17,4,13
103,103,2010-2,6,21,18,3,15
103,103,2010-C,3,11,11,0,16
103,103,2011-1,6,21,17,4,14
103,103,2011-2,6,22,15,7,12
103,103,2011-3,6,22,14,8,12
103,103,2012-1,6,22,22,0,15
103,103,2012-2,6,20,17,3,14
103,103,2013-1,2,8,4,4,13
103,103,2013-2,6,22,22,0,15
103,103,2013-3,6,22,18,4,14
103,103,2014-1,6,21,17,4,15
103,103,2014-2,4,13,13,0,15
103,103,2015-1,3,11,11,0,15
104,104,2010-1,6,21,21,0,15
104,104,2010-2,6,22,19,3,14
104,104,2010-C,3,12,8,4,13
104,104,2011-1,6,22,10,12,9
104,104,2011-2,6,22,6,16,6
104,104,2011-3,4,15,0,15,7
104,104,2012-1,6,21,14,7,14
104,104,2012-2,5,20,16,4,15
104,104,2013-1,6,22,18,4,14
104,104,2013-2,5,20,16,4,14
104,104,2014-1,6,21,15,6,14
104,104,2015-1,4,15,11,4,14
104,104,2015-2,4,15,12,3,14
105,105,2010-1,6,21,21,0,16
105,105,2010-2,5,18,14,4,13
105,105,2010-C,2,7,3,4,7
105,105,2011-1,6,22,22,0,16
105,105,2011-2,6,21,17,4,12
105,105,2011-3,4,15,15,0,15
105,105,2012-1,6,21,21,0,15
105,105,2012-2,6,21,21,0,14
105,105,2013-1,6,22,18,4,14
105,105,2013-2,6,22,14,8,9
105,105,2013-3,5,19,7,12,7
105,105,2014-1,6,22,14,8,13
105,105,2014-2,4,15,8,7,12
105,105,2015-1,6,21,21,0,15
106,106,2010-1,6,21,3,18,4
106,106,2010-2,5,18,6,12,11
106,106,2011-1,5,18,15,3,13
106,106,2011-2,6,21,14,7,11
106,106,2011-3,6,22,18,4,15
106,106,2012-1,6,22,0,22,2
106,106,2012-2,6,22,11,11,11
106,106,2013-2,6,22,18,4,14
106,106,2013-3,6,22,22,0,16
106,106,2014-1,6,22,22,0,15
106,106,2014-2,6,22,22,0,15
106,106,2015-1,6,22,22,0,15
106,106,2015-2,7,22,22,0,15
107,107,2010-1,6,21,17,4,15
107,107,2010-2,6,21,21,0,15
107,107,2011-1,6,22,22,0,16
107,107,2011-2,6,22,22,0,16
107,107,2011-3,6,22,22,0,17
107,107,2012-1,7,25,25,0,17
107,107,2012-2,6,22,22,0,16
107,107,2013-1,6,22,22,0,17
107,107,2013-2,6,22,22,0,17
107,107,2013-3,7,21,21,0,16
108,108,2010-1,6,21,21,0,15
108,108,2010-2,6,21,10,11,14
108,108,2010-C,3,12,8,4,11
108,108,2011-1,6,22,18,4,15
108,108,2011-2,6,22,14,8,13
108,108,2011-3,6,21,17,4,15
108,108,2012-1,6,22,22,0,16
108,108,2012-2,6,22,22,0,15
108,108,2013-1,6,22,22,0,15
108,108,2013-2,6,22,22,0,15
108,108,2013-3,6,22,22,0,15
108,108,2014-1,6,18,18,0,15
109,109,2010-1,6,21,14,7,14
109,109,2010-2,6,21,17,4,14
109,109,2011-1,6,22,14,8,12
109,109,2011-2,6,22,10,12,8
109,109,2011-3,6,22,18,4,13
109,109,2012-1,6,22,0,22,7
109,109,2012-2,5,20,16,4,13
109,109,2013-2,5,20,20,0,14
109,109,2013-3,6,22,18,4,14
109,109,2014-1,6,22,18,4,13
109,109,2014-2,6,22,22,0,15
109,109,2015-1,6,22,22,0,14
109,109,2015-2,4,13,6,7,10
110,110,2010-1,6,21,21,0,15
110,110,2010-2,6,21,11,10,13
110,110,2011-1,6,22,22,0,15
111,111,2010-1,6,21,17,4,14
111,111,2010-2,6,21,14,7,14
111,111,2011-1,6,22,18,4,14
111,111,2011-2,6,21,13,8,13
111,111,2011-3,6,21,14,7,13
111,111,2012-1,6,21,11,10,11
111,111,2012-2,5,17,17,0,15
111,111,2013-1,6,22,22,0,15
111,111,2013-2,6,22,18,4,12
111,111,2013-3,5,20,4,16,9
111,111,2014-1,5,20,12,8,12
111,111,2014-2,5,20,20,0,15
111,111,2015-1,6,21,21,0,14
111,111,2015-2,5,15,15,0,14
112,112,2010-1,4,15,15,0,14
112,112,2010-2,4,14,7,7,10
112,112,2010-C,2,8,8,0,16
112,112,2011-1,5,18,7,11,12
112,112,2011-2,5,18,15,3,12
112,112,2011-3,6,22,18,4,11
112,112,2012-1,6,21,10,11,11
112,112,2012-2,4,14,14,0,15
112,112,2013-1,5,18,3,15,10
112,112,2013-2,5,19,7,12,13
112,112,2013-3,6,22,14,8,13
112,112,2014-1,5,18,14,4,14
112,112,2014-2,6,22,14,8,13
112,112,2015-1,6,21,21,0,14
112,112,2015-2,4,14,14,0,15
113,113,2010-1,6,21,17,4,14
113,113,2010-2,6,22,18,4,13
113,113,2010-C,3,11,7,4,14
113,113,2011-1,6,21,21,0,15
113,113,2011-2,6,22,18,4,15
113,113,2011-3,6,22,15,7,14
113,113,2012-1,6,21,18,3,15
113,113,2012-2,6,22,22,0,15
113,113,2013-1,6,22,22,0,15
113,113,2013-2,6,22,15,7,14
113,113,2013-3,6,22,22,0,14
113,113,2014-1,7,21,21,0,15
114,114,2010-1,6,21,6,15,11
115,115,2010-1,6,21,21,0,15
115,115,2010-2,6,22,22,0,16
115,115,2010-C,3,11,11,0,15
115,115,2011-2,4,15,7,8,13
115,115,2012-2,4,14,14,0,16
115,115,2013-1,6,22,22,0,15
115,115,2013-2,6,22,22,0,15
115,115,2013-3,6,22,18,4,14
115,115,2014-1,6,22,22,0,16
115,115,2014-2,6,22,22,0,15
115,115,2015-1,7,22,22,0,15
115,115,2015-2,4,13,13,0,17
116,116,2010-1,4,13,13,0,15
116,116,2010-2,4,15,12,3,13
116,116,2010-C,3,12,8,4,11
116,116,2011-1,6,20,20,0,16
116,116,2011-2,6,21,21,0,14
116,116,2011-3,6,22,22,0,15
116,116,2012-1,6,22,18,4,15
116,116,2012-2,6,22,18,4,12
116,116,2013-1,6,22,22,0,15
116,116,2013-2,6,22,22,0,14
116,116,2013-3,6,20,20,0,15
116,116,2014-1,2,7,7,0,15
117,117,2010-1,6,21,13,8,14
117,117,2010-2,6,21,10,11,8
117,117,2010-C,3,11,7,4,14
117,117,2011-1,6,21,17,4,14
117,117,2011-2,6,22,11,11,11
117,117,2012-1,6,20,13,7,11
117,117,2012-2,6,21,13,8,11
117,117,2013-1,6,22,4,18,10
117,117,2013-2,5,19,12,7,11
117,117,2013-3,6,22,7,15,8
117,117,2014-1,6,22,0,22,8
118,118,2010-1,6,21,21,0,15
118,118,2010-2,6,22,15,7,14
118,118,2010-C,3,12,12,0,16
118,118,2011-1,6,22,22,0,14
118,118,2011-2,6,22,18,4,14
118,118,2011-3,6,22,10,12,13
118,118,2012-1,6,22,18,4,14
118,118,2012-2,6,22,7,15,11
118,118,2013-1,6,21,0,21,0
118,118,2014-2,6,22,18,4,15
118,118,2015-1,6,22,22,0,15
118,118,2015-2,6,22,14,8,14
119,119,2010-1,6,21,17,4,14
119,119,2010-2,6,21,17,4,15
119,119,2010-C,3,11,4,7,9
119,119,2011-2,6,21,13,8,11
119,119,2011-3,7,22,6,16,10
119,119,2012-1,7,21,7,14,10
119,119,2013-2,7,22,17,5,12
119,119,2013-3,7,22,4,18,9
119,119,2014-1,7,22,15,7,12
119,119,2014-2,7,22,7,15,7
119,119,2015-2,8,20,19,1,15
120,120,2010-1,7,22,18,4,14
120,120,2010-2,6,21,21,0,15
120,120,2010-C,3,11,11,0,15
120,120,2011-1,6,21,17,4,14
120,120,2011-2,6,22,15,7,13
120,120,2011-3,6,21,17,4,14
120,120,2012-1,6,22,8,14,11
120,120,2012-2,7,22,10,12,13
120,120,2013-1,7,22,11,11,13
120,120,2013-2,7,21,21,0,14
120,120,2013-3,7,22,14,8,13
120,120,2014-1,6,22,11,11,13
120,120,2014-2,6,22,22,0,15
120,120,2015-1,5,20,20,0,15
121,121,2010-1,7,22,10,12,10
121,121,2010-2,6,21,17,4,13
121,121,2010-C,3,12,12,0,15
121,121,2011-1,6,21,20,1,14
121,121,2011-2,6,22,15,7,13
121,121,2011-3,7,20,15,5,11
121,121,2012-1,7,22,18,4,14
121,121,2012-2,6,21,7,14,9
121,121,2013-1,6,21,14,7,11
122,122,2010-1,6,22,7,15,7
122,122,2010-2,5,14,0,14,0
122,122,2013-1,7,19,3,16,7
123,123,2010-1,6,21,6,15,9
123,123,2010-2,7,22,7,15,11
123,123,2011-1,6,19,4,15,4
123,123,2011-2,4,15,0,15,3
123,123,2012-1,4,15,0,15,5
124,124,2010-1,6,21,10,11,12
124,124,2010-2,7,22,14,8,14
124,124,2010-C,3,11,7,4,13
124,124,2011-1,7,21,0,21,0
125,125,2010-1,6,21,6,15,9
125,125,2010-2,7,22,6,16,9
125,125,2010-C,3,11,8,3,12
125,125,2011-1,6,19,11,8,11
126,126,2010-1,6,20,20,0,17
126,126,2010-C,3,11,11,0,16
126,126,2011-1,5,15,8,7,11
126,126,2011-2,3,11,7,4,10
126,126,2013-1,5,15,11,4,13
126,126,2013-2,6,22,22,0,17
126,126,2013-3,6,22,22,0,16
126,126,2014-1,8,22,22,0,17
126,126,2014-2,8,26,26,0,17
126,126,2015-1,3,15,15,0,17
127,127,2010-1,6,21,13,8,12
127,127,2010-2,5,19,11,8,10
127,127,2010-C,2,7,7,0,15
127,127,2011-1,6,21,5,16,10
127,127,2011-2,6,21,4,17,6
127,127,2011-3,6,20,1,19,4
127,127,2012-1,5,19,0,19,5
127,127,2012-2,6,22,3,19,9
127,127,2013-1,6,21,1,20,4
127,127,2013-2,5,20,4,16,7
127,127,2013-3,6,22,3,19,9
127,127,2014-1,6,22,10,12,11
127,127,2014-2,7,20,16,4,12
127,127,2015-1,5,18,14,4,15
127,127,2015-2,6,20,20,0,15
128,128,2010-1,6,21,13,8,13
128,128,2010-2,6,22,14,8,13
128,128,2010-C,3,11,11,0,15
128,128,2011-1,6,21,17,4,13
128,128,2011-2,6,20,12,8,13
128,128,2011-3,6,22,11,11,9
128,128,2012-1,6,20,16,4,14
128,128,2012-2,6,20,13,7,13
128,128,2013-1,7,22,7,15,12
128,128,2013-2,6,22,4,18,12
128,128,2013-3,6,21,14,7,14
128,128,2014-1,6,20,17,3,14
128,128,2014-2,7,22,18,4,14
128,128,2015-1,6,22,18,4,14
128,128,2015-2,6,20,17,3,14
129,129,2010-1,6,21,9,12,10
129,129,2010-2,6,22,14,8,11
129,129,2010-C,3,11,11,0,15
129,129,2011-1,7,22,20,2,14
129,129,2011-2,6,20,0,20,10
129,129,2011-3,7,21,19,2,14
129,129,2012-1,8,22,3,19,8
129,129,2012-2,6,22,22,0,14
129,129,2013-1,6,21,13,8,13
129,129,2013-2,7,22,22,0,14
129,129,2013-3,6,20,10,10,12
129,129,2014-1,6,21,14,7,12
129,129,2014-2,7,20,13,7,14
129,129,2015-1,6,21,18,3,14
129,129,2015-2,5,21,11,10,12
130,130,2010-1,6,21,13,8,14
130,130,2010-2,7,22,18,4,15
130,130,2011-1,4,16,4,12,11
130,130,2011-2,4,16,12,4,14
130,130,2011-3,6,20,16,4,14
130,130,2012-1,6,22,19,3,14
130,130,2012-2,6,19,9,10,13
130,130,2013-1,7,22,10,12,11
130,130,2013-2,6,22,7,15,11
130,130,2013-3,7,22,4,18,7
130,130,2015-2,7,22,0,22,3
131,131,2010-2,7,22,17,5,15
131,131,2012-1,6,20,3,17,5
131,131,2013-1,6,22,11,11,13
131,131,2013-2,8,22,19,3,14
131,131,2013-3,8,22,9,13,13
131,131,2014-1,7,22,19,3,14
131,131,2014-2,7,22,22,0,15
131,131,2015-1,7,22,21,1,14
131,131,2015-2,7,22,22,0,15
132,132,2010-1,6,21,3,18,5
132,132,2010-2,7,22,9,13,9
132,132,2011-1,6,19,0,19,10
132,132,2011-2,6,19,3,16,4
132,132,2011-3,6,20,0,20,3
132,132,2012-1,4,16,4,12,7
132,132,2012-2,4,15,4,11,6
132,132,2013-1,6,20,4,16,7
132,132,2013-2,6,21,0,21,2
132,132,2013-3,4,13,0,13,0
132,132,2014-1,5,14,6,8,12
132,132,2015-1,4,13,6,7,10
132,132,2015-2,4,15,4,11,7
133,133,2010-1,6,21,18,3,12
133,133,2010-2,6,21,13,8,13
133,133,2010-C,3,11,3,8,4
133,133,2011-1,6,21,5,16,9
133,133,2011-2,5,20,12,8,9
133,133,2011-3,6,21,12,9,11
133,133,2012-1,6,20,20,0,14
133,133,2012-2,6,22,12,10,10
133,133,2013-1,7,22,12,10,14
133,133,2013-2,8,22,12,10,12
133,133,2013-3,6,21,9,12,11
133,133,2014-1,6,21,14,7,12
133,133,2014-2,6,22,18,4,14
133,133,2015-1,7,20,20,0,15
133,133,2015-2,6,21,14,7,14
134,134,2010-1,5,18,18,0,17
134,134,2010-2,6,19,19,0,17
134,134,2011-1,6,20,16,4,13
134,134,2011-2,7,22,14,8,13
134,134,2011-3,6,22,18,4,14
134,134,2012-1,8,22,22,0,16
134,134,2012-2,6,22,22,0,16
134,134,2013-1,6,20,16,4,16
134,134,2013-2,2,12,12,0,17
134,134,2013-3,2,7,7,0,14
135,135,2010-1,6,21,18,3,14
135,135,2010-2,7,22,14,8,13
135,135,2010-C,2,7,4,3,13
135,135,2011-1,6,20,11,9,11
135,135,2011-2,5,17,17,0,15
135,135,2011-3,5,19,11,8,11
135,135,2012-1,6,22,10,12,11
135,135,2012-2,4,15,0,15,10
135,135,2013-1,4,15,3,12,11
135,135,2013-2,6,22,22,0,14
135,135,2013-3,8,22,11,11,14
135,135,2014-1,6,20,20,0,16
135,135,2014-2,6,20,20,0,16
135,135,2015-1,7,21,21,0,15
135,135,2015-2,6,22,22,0,16
136,136,2010-1,6,21,6,15,6
136,136,2010-2,7,22,6,16,6
136,136,2010-C,3,11,7,4,11
136,136,2011-1,6,20,0,20,3
136,136,2011-2,4,15,0,15,3
136,136,2011-3,5,17,0,17,4
136,136,2012-1,4,15,0,15,3
136,136,2012-2,4,15,3,12,9
136,136,2013-1,5,19,0,19,3
136,136,2013-2,3,11,0,11,8
136,136,2013-3,5,17,10,7,11
136,136,2014-1,6,20,16,4,12
136,136,2014-2,6,20,0,20,2
136,136,2015-1,6,20,13,7,14
136,136,2015-2,6,19,15,4,12
137,137,2010-1,7,22,14,8,13
137,137,2010-2,6,21,21,0,15
137,137,2011-1,5,19,11,8,12
137,137,2011-2,5,20,20,0,15
137,137,2011-3,7,22,22,0,15
137,137,2012-1,7,22,14,8,13
137,137,2012-2,5,20,16,4,14
137,137,2013-1,7,21,20,1,15
137,137,2013-2,8,21,21,0,15
137,137,2013-3,6,22,22,0,14
137,137,2014-1,5,22,14,8,13
137,137,2014-2,5,21,18,3,15
137,137,2015-1,1,3,3,0,14
138,138,2010-1,6,21,21,0,15
138,138,2010-2,6,22,22,0,16
138,138,2010-C,3,11,7,4,9
138,138,2011-1,7,21,20,1,15
138,138,2011-2,7,21,21,0,15
138,138,2011-3,6,20,20,0,15
138,138,2012-1,7,21,14,7,13
138,138,2012-2,7,21,21,0,15
138,138,2013-1,6,20,17,3,15
138,138,2013-2,6,21,21,0,15
138,138,2013-3,6,21,21,0,15
138,138,2014-1,2,11,11,0,16
139,139,2010-1,6,21,10,11,11
139,139,2010-2,6,21,17,4,14
139,139,2010-C,3,11,4,7,10
139,139,2011-1,6,20,16,4,14
139,139,2011-2,6,22,18,4,13
139,139,2011-3,7,21,21,0,15
139,139,2012-1,6,22,22,0,15
139,139,2012-2,7,22,22,0,15
139,139,2013-1,7,22,22,0,16
139,139,2013-2,7,22,15,7,14
139,139,2013-3,6,22,22,0,15
139,139,2014-1,5,21,21,0,16
139,139,2014-2,3,9,9,0,17
140,140,2010-1,4,14,6,8,9
140,140,2010-2,5,18,6,12,11
140,140,2011-1,4,16,8,8,11
140,140,2011-2,4,16,8,8,11
140,140,2011-3,6,21,21,0,14
140,140,2012-1,6,22,18,4,14
140,140,2012-2,6,22,15,7,13
140,140,2013-1,7,22,18,4,15
140,140,2013-2,7,22,12,10,12
140,140,2013-3,7,22,15,7,12
140,140,2014-1,7,22,7,15,13
140,140,2014-2,6,22,22,0,16
140,140,2015-1,6,21,21,0,16
140,140,2015-2,5,21,6,15,9
141,141,2010-1,6,21,10,11,10
141,141,2010-2,6,21,21,0,16
141,141,2010-C,3,11,8,3,14
141,141,2011-1,7,21,21,0,15
141,141,2011-2,6,22,18,4,14
141,141,2011-3,6,22,3,19,8
141,141,2012-1,6,22,8,14,9
141,141,2012-2,7,22,9,13,11
141,141,2013-1,6,20,20,0,16
141,141,2013-2,6,20,0,20,7
141,141,2014-1,7,21,1,20,3
141,141,2014-2,6,20,13,7,11
141,141,2015-1,6,21,21,0,15
141,141,2015-2,7,21,18,3,15
142,142,2010-1,7,22,3,19,3
142,142,2010-2,7,22,0,22,2
142,142,2011-1,7,22,0,22,1
142,142,2011-3,6,21,7,14,6
142,142,2012-1,7,22,9,13,7
142,142,2012-2,6,22,0,22,2
142,142,2013-2,4,13,0,13,4
142,142,2013-3,5,16,4,12,5
142,142,2014-1,6,20,3,17,5
142,142,2014-2,6,20,5,15,5
142,142,2015-1,6,20,7,13,8
142,142,2015-2,6,20,11,9,9
143,143,2010-1,5,15,11,4,14
143,143,2010-2,7,22,15,7,11
143,143,2011-1,6,22,22,0,15
143,143,2011-2,5,18,14,4,12
143,143,2011-3,8,21,21,0,15
143,143,2012-1,7,22,15,7,13
143,143,2012-2,6,21,13,8,13
143,143,2013-1,6,21,18,3,15
143,143,2013-2,5,19,19,0,15
143,143,2013-3,5,22,18,4,14
143,143,2014-1,3,10,6,4,13
143,143,2014-2,1,4,4,0,14
144,144,2010-1,6,21,17,4,14
144,144,2010-2,7,20,15,5,14
144,144,2010-C,3,11,11,0,15
144,144,2011-1,6,21,16,5,14
144,144,2011-2,6,22,8,14,11
144,144,2011-3,6,19,8,11,11
144,144,2012-1,6,22,16,6,14
144,144,2012-2,7,21,10,11,11
144,144,2013-1,7,21,11,10,13
144,144,2013-2,7,22,13,9,13
144,144,2013-3,6,20,6,14,10
144,144,2014-1,6,21,18,3,13
144,144,2014-2,7,22,18,4,13
144,144,2015-1,7,20,16,4,15
144,144,2015-2,6,21,14,7,12
145,145,2010-1,6,21,13,8,11
145,145,2010-2,6,19,16,3,14
145,145,2010-C,3,11,7,4,13
145,145,2011-1,6,19,15,4,14
145,145,2011-2,6,21,21,0,15
145,145,2011-3,6,21,14,7,11
145,145,2012-1,6,22,18,4,14
145,145,2012-2,7,22,14,8,13
145,145,2013-1,6,21,17,4,14
145,145,2013-2,6,20,9,11,13
145,145,2013-3,7,22,10,12,13
145,145,2014-1,6,22,14,8,13
145,145,2014-2,7,22,18,4,13
145,145,2015-1,4,15,7,8,12
145,145,2015-2,2,8,4,4,14
146,146,2010-1,6,21,17,4,14
146,146,2010-2,6,19,12,7,10
146,146,2010-C,3,11,7,4,9
146,146,2011-1,6,20,19,1,15
146,146,2011-2,6,22,18,4,14
146,146,2011-3,7,22,17,5,12
146,146,2012-1,7,21,17,4,14
146,146,2012-2,6,22,8,14,10
146,146,2013-1,7,21,14,7,14
146,146,2013-2,7,22,9,13,12
146,146,2013-3,7,21,14,7,14
146,146,2014-1,6,20,17,3,15
146,146,2014-2,6,21,14,7,13
146,146,2015-1,6,21,10,11,12
146,146,2015-2,5,23,8,15,12
147,147,2010-1,6,21,13,8,10
147,147,2010-2,8,22,19,3,14
147,147,2010-C,3,11,11,0,15
147,147,2011-1,6,22,19,3,14
147,147,2011-2,6,22,18,4,14
147,147,2011-3,7,22,19,3,13
147,147,2012-1,7,20,20,0,15
147,147,2012-2,7,22,18,4,15
147,147,2013-1,6,20,20,0,15
147,147,2013-2,6,22,22,0,15
147,147,2013-3,3,14,14,0,15
148,148,2010-1,6,21,3,18,9
148,148,2010-2,6,21,11,10,12
148,148,2011-1,7,22,9,13,8
148,148,2011-2,6,20,8,12,11
148,148,2011-3,4,16,4,12,11
148,148,2012-1,5,19,11,8,11
148,148,2012-2,6,22,14,8,11
148,148,2013-1,6,21,17,4,13
148,148,2013-2,6,21,13,8,10
148,148,2013-3,6,22,11,11,8
148,148,2014-1,7,22,14,8,14
148,148,2014-2,6,22,11,11,12
148,148,2015-1,7,22,22,0,14
148,148,2015-2,7,22,21,1,14
149,149,2010-1,7,22,14,8,12
149,149,2010-2,5,16,5,11,11
149,149,2010-C,3,11,3,8,6
149,149,2011-1,4,14,10,4,12
149,149,2011-2,6,20,6,14,12
149,149,2011-3,4,13,0,13,6
149,149,2013-1,4,13,0,13,0
149,149,2013-3,3,11,0,11,3
149,149,2014-1,4,15,7,8,7
149,149,2014-2,4,15,3,12,6
149,149,2015-1,3,12,0,12,0
149,149,2015-2,3,12,0,12,1
150,150,2010-1,7,22,22,0,15
150,150,2010-2,7,22,22,0,15
150,150,2010-C,3,11,11,0,14
150,150,2011-1,6,20,20,0,16
150,150,2011-2,4,13,13,0,18
150,150,2011-3,6,22,19,3,16
150,150,2012-1,6,22,22,0,17
150,150,2012-2,6,22,19,3,16
150,150,2013-1,6,21,18,3,16
150,150,2013-2,4,13,13,0,14
150,150,2013-3,5,19,19,0,15
150,150,2014-1,6,19,19,0,16
151,151,2010-1,7,22,22,0,15
151,151,2010-2,7,21,11,10,10
151,151,2010-C,3,11,8,3,12
151,151,2011-1,6,20,13,7,13
151,151,2011-2,4,15,0,15,10
151,151,2011-3,6,20,16,4,15
151,151,2012-1,6,22,18,4,14
151,151,2012-2,5,19,19,0,16
151,151,2013-1,4,14,14,0,16
151,151,2013-2,6,21,21,0,16
151,151,2013-3,5,19,15,4,14
151,151,2014-1,6,22,22,0,16
151,151,2014-2,4,15,15,0,16
151,151,2015-1,7,23,23,0,17
152,152,2010-1,7,22,14,8,13
152,152,2010-2,6,19,3,16,8
152,152,2011-1,5,16,16,0,14
152,152,2011-2,6,19,3,16,8
153,153,2010-1,7,22,20,2,14
153,153,2010-2,7,22,14,8,13
153,153,2010-C,2,6,2,4,11
153,153,2011-1,5,16,16,0,15
153,153,2011-2,6,20,6,14,12
153,153,2011-3,6,21,14,7,12
153,153,2012-1,3,11,11,0,14
153,153,2012-2,3,12,8,4,13
153,153,2013-1,5,19,19,0,14
153,153,2013-2,6,21,18,3,14
153,153,2013-3,5,19,15,4,13
153,153,2014-1,6,22,22,0,15
153,153,2014-2,5,19,19,0,14
153,153,2015-1,6,22,22,0,14
153,153,2015-2,4,11,11,0,15
154,154,2010-1,7,22,14,8,10
154,154,2010-2,6,19,15,4,13
154,154,2010-C,3,11,7,4,12
154,154,2011-1,5,16,13,3,14
154,154,2011-2,6,20,3,17,8
154,154,2011-3,6,21,11,10,13
154,154,2012-1,5,17,14,3,13
154,154,2012-2,4,14,10,4,11
154,154,2013-1,4,15,11,4,12
154,154,2013-2,4,16,12,4,12
154,154,2013-3,6,22,18,4,15
154,154,2014-1,6,22,22,0,15
154,154,2014-2,5,19,19,0,14
154,154,2015-1,6,22,19,3,14
154,154,2015-2,6,20,20,0,15
155,155,2010-1,7,22,14,8,10
155,155,2010-2,6,19,5,14,9
155,155,2010-C,3,11,0,11,0
156,156,2010-1,7,22,18,4,13
156,156,2010-C,1,4,0,4,11
156,156,2011-1,7,22,18,4,14
157,157,2010-1,7,22,18,4,14
157,157,2010-C,2,7,0,7,2
157,157,2011-1,6,19,15,4,14
157,157,2011-2,6,19,6,13,12
157,157,2011-3,4,13,5,8,9
157,157,2012-1,5,18,11,7,13
157,157,2012-2,4,14,11,3,13
158,158,2010-1,7,22,18,4,14
158,158,2010-2,7,22,18,4,12
158,158,2010-C,3,11,11,0,14
158,158,2011-1,6,20,12,8,12
158,158,2011-2,6,21,8,13,9
158,158,2011-3,6,21,7,14,6
158,158,2012-1,5,17,17,0,15
158,158,2012-2,5,19,19,0,16
158,158,2013-1,6,22,22,0,16
158,158,2013-2,6,22,22,0,16
158,158,2013-3,6,22,22,0,15
158,158,2014-1,6,22,14,8,14
158,158,2014-2,6,21,13,8,11
158,158,2015-1,4,14,10,4,11
158,158,2015-2,1,4,0,4,0
159,159,2010-1,6,16,9,7,8
159,159,2010-2,5,16,10,6,9
159,159,2010-C,3,10,10,0,16
159,159,2011-1,6,21,18,3,13
159,159,2011-2,6,21,8,13,8
159,159,2011-3,6,21,21,0,16
159,159,2012-1,6,22,18,4,14
159,159,2012-2,5,19,19,0,16
159,159,2013-1,6,22,22,0,15
159,159,2013-2,5,15,15,0,16
159,159,2013-3,3,11,11,0,15
160,160,2010-1,7,22,0,22,0
160,160,2010-2,7,22,0,22,3
160,160,2012-1,7,22,2,20,3
160,160,2012-2,6,20,0,20,3
161,161,2010-1,7,22,22,0,15
161,161,2010-2,7,22,22,0,15
161,161,2010-C,3,9,9,0,16
161,161,2011-1,7,22,16,6,13
161,161,2011-2,6,19,16,3,12
161,161,2011-3,5,19,13,6,11
161,161,2012-1,7,22,12,10,12
161,161,2012-2,6,19,16,3,14
161,161,2013-1,7,22,22,0,14
161,161,2013-2,6,20,13,7,14
161,161,2013-3,7,22,22,0,14
161,161,2014-1,6,19,12,7,13
161,161,2014-2,6,20,20,0,15
162,162,2010-1,7,22,0,22,0
163,163,2010-1,7,22,22,0,16
163,163,2010-2,7,22,22,0,15
163,163,2011-1,7,22,19,3,14
163,163,2011-2,7,22,22,0,15
163,163,2011-3,5,20,20,0,15
163,163,2012-1,7,22,19,3,13
163,163,2012-2,7,22,22,0,15
163,163,2013-1,7,22,15,7,15
163,163,2013-2,7,22,19,3,15
163,163,2013-3,7,22,19,3,15
163,163,2014-1,5,16,13,3,13
163,163,2014-2,1,3,3,0,15
164,164,2010-1,7,22,22,0,16
164,164,2010-2,7,22,22,0,15
164,164,2010-C,2,6,6,0,15
164,164,2011-1,7,22,19,3,15
164,164,2011-2,7,22,12,10,10
164,164,2011-3,5,20,11,9,9
164,164,2012-1,6,22,17,5,14
164,164,2012-2,6,20,12,8,10
164,164,2013-1,6,20,17,3,15
164,164,2013-2,7,22,9,13,11
164,164,2013-3,4,13,6,7,12
164,164,2014-1,6,19,16,3,13
164,164,2014-2,5,17,10,7,11
165,165,2010-2,7,22,0,22,1
165,165,2011-1,7,22,2,20,0
165,165,2011-3,6,20,10,10,10
165,165,2012-1,6,20,20,0,15
165,165,2012-2,7,22,16,6,13
165,165,2013-1,6,18,9,9,9
165,165,2013-2,5,16,3,13,9
165,165,2013-3,5,16,0,16,5
165,165,2014-1,6,19,0,19,0
165,165,2014-2,6,19,0,19,4
165,165,2015-1,6,19,0,19,1
165,165,2015-2,6,19,0,19,0
166,166,2010-1,7,22,22,0,15
166,166,2010-2,7,22,0,22,5
167,167,2010-1,7,22,0,22,0
168,168,2010-1,7,22,22,0,16
168,168,2010-2,7,22,22,0,16
168,168,2010-C,3,9,9,0,16
168,168,2011-1,7,22,22,0,16
168,168,2011-2,4,13,10,3,14
168,168,2011-3,5,20,17,3,13
168,168,2012-1,7,22,19,3,14
168,168,2012-2,7,22,22,0,15
168,168,2013-1,6,19,12,7,13
168,168,2013-2,7,22,22,0,15
168,168,2013-3,7,22,22,0,15
168,168,2014-1,5,16,16,0,16
169,169,2010-1,7,22,22,0,16
169,169,2010-2,7,22,22,0,16
169,169,2010-C,2,6,6,0,18
169,169,2011-1,7,22,16,6,14
169,169,2011-2,7,22,22,0,15
169,169,2011-3,5,20,17,3,13
169,169,2012-1,7,22,22,0,15
169,169,2012-2,7,22,22,0,16
169,169,2013-1,7,22,22,0,16
169,169,2013-2,7,22,22,0,15
169,169,2013-3,7,22,22,0,16
170,170,2010-1,7,22,22,0,17
170,170,2010-2,7,22,19,3,14
170,170,2010-C,2,6,6,0,16
170,170,2011-1,7,22,22,0,15
170,170,2011-2,7,22,22,0,15
170,170,2011-3,5,21,21,0,15
170,170,2012-1,6,18,18,0,14
170,170,2012-2,7,22,22,0,15
170,170,2013-1,7,22,18,4,14
170,170,2013-2,7,22,22,0,15
170,170,2013-3,7,23,23,0,14
171,171,2010-1,7,22,22,0,17
171,171,2010-2,7,22,22,0,16
171,171,2011-1,7,22,22,0,16
171,171,2011-2,7,22,22,0,16
171,171,2011-3,4,17,17,0,16
171,171,2012-1,7,22,22,0,16
171,171,2012-2,7,22,22,0,17
171,171,2013-1,7,22,22,0,16
171,171,2013-2,7,22,22,0,16
171,171,2013-3,7,22,22,0,16
172,172,2010-1,7,22,22,0,16
172,172,2010-2,7,22,22,0,16
172,172,2010-C,2,6,6,0,14
172,172,2011-1,7,22,22,0,16
172,172,2011-2,6,20,16,4,13
172,172,2011-3,5,20,20,0,15
172,172,2012-1,7,22,22,0,16
172,172,2012-2,7,22,22,0,16
172,172,2013-1,7,22,22,0,15
172,172,2013-2,7,22,22,0,16
172,172,2013-3,6,19,19,0,15
173,173,2010-1,7,22,19,3,13
173,173,2010-2,7,22,22,0,15
173,173,2010-C,3,9,6,3,10
173,173,2011-1,7,22,16,6,13
173,173,2011-2,7,22,15,7,11
173,173,2011-3,6,22,22,0,15
173,173,2012-1,6,21,21,0,15
173,173,2012-2,7,22,18,4,14
173,173,2013-1,6,20,20,0,15
173,173,2013-2,7,22,22,0,15
173,173,2013-3,6,19,19,0,15
173,173,2014-1,5,15,9,6,15
173,173,2014-2,2,6,6,0,15
174,174,2010-1,7,22,12,10,8
175,175,2010-1,7,22,22,0,16
175,175,2010-2,7,22,22,0,16
175,175,2010-C,3,9,9,0,15
175,175,2011-1,7,22,16,6,12
175,175,2011-2,7,22,13,9,10
175,175,2011-3,6,22,8,14,6
175,175,2012-1,6,19,3,16,6
175,175,2012-2,7,21,15,6,14
175,175,2013-1,6,20,14,6,12
175,175,2013-2,6,20,4,16,7
175,175,2013-3,7,22,3,19,7
175,175,2014-1,5,16,6,10,8
175,175,2014-2,6,19,9,10,8
175,175,2015-1,6,19,9,10,8
175,175,2015-2,7,22,16,6,12
176,176,2010-1,7,22,22,0,18
176,176,2010-2,7,22,22,0,15
176,176,2010-C,2,6,3,3,13
176,176,2011-1,7,22,22,0,14
176,176,2011-2,7,22,16,6,13
176,176,2011-3,4,15,12,3,14
176,176,2012-1,5,17,17,0,15
176,176,2012-2,6,20,13,7,14
176,176,2013-1,6,19,16,3,14
176,176,2013-2,7,22,6,16,11
176,176,2013-3,6,20,10,10,11
176,176,2014-1,5,15,3,12,11
176,176,2014-2,6,20,14,6,13
176,176,2015-1,7,21,12,9,13
176,176,2015-2,5,15,3,12,10
177,177,2011-1,6,21,17,4,13
177,177,2011-2,6,21,10,11,11
177,177,2011-3,4,14,7,7,11
177,177,2012-1,6,22,7,15,7
177,177,2012-2,4,15,3,12,4
177,177,2014-2,5,14,10,4,15
177,177,2015-1,3,12,12,0,14
177,177,2015-2,2,8,0,8,1
178,178,2010-1,6,21,18,3,14
178,178,2010-C,2,8,0,8,0
178,178,2011-1,6,21,18,3,14
178,178,2011-2,6,22,12,10,9
178,178,2011-3,6,22,19,3,16
178,178,2012-1,6,21,18,3,16
178,178,2012-2,5,18,7,11,10
178,178,2013-1,4,14,6,8,11
178,178,2014-1,4,15,0,15,3
179,179,2010-1,3,10,10,0,18
179,179,2010-2,3,11,11,0,16
179,179,2011-1,3,9,9,0,14
179,179,2011-2,3,12,4,8,11
179,179,2012-2,2,8,8,0,17
179,179,2013-1,1,4,4,0,16
179,179,2013-2,3,10,10,0,16
179,179,2014-1,4,14,14,0,16
179,179,2014-2,6,22,22,0,15
179,179,2015-1,6,22,22,0,16
179,179,2015-2,4,13,13,0,16
180,180,2010-1,7,22,22,0,16
180,180,2010-2,7,22,22,0,15
180,180,2010-C,3,9,9,0,17
180,180,2011-1,7,22,19,3,14
180,180,2011-2,6,20,20,0,16
180,180,2011-3,5,19,9,10,8
180,180,2012-1,4,12,9,3,13
180,180,2012-2,6,20,20,0,16
180,180,2013-1,7,22,22,0,15
180,180,2013-2,4,13,10,3,14
180,180,2014-1,6,19,19,0,16
180,180,2014-2,6,19,19,0,17
180,180,2015-1,2,6,6,0,17
181,181,2010-1,7,22,0,22,0
181,181,2010-2,5,18,10,8,9
181,181,2010-C,2,7,7,0,15
181,181,2011-1,6,20,3,17,5
181,181,2011-2,5,20,0,20,0
181,181,2011-3,5,17,11,6,14
181,181,2012-1,6,20,0,20,0
181,181,2012-2,5,18,0,18,5
181,181,2013-1,6,22,6,16,4
181,181,2013-2,5,20,20,0,15
181,181,2013-3,7,22,15,7,10
182,182,2010-1,4,9,9,0,17
182,182,2010-2,4,14,11,3,12
182,182,2010-C,3,10,10,0,15
182,182,2011-1,6,22,22,0,15
182,182,2011-2,6,22,22,0,16
182,182,2011-3,6,22,14,8,14
182,182,2012-1,5,19,16,3,15
182,182,2012-2,5,15,15,0,16
182,182,2013-1,2,7,7,0,17
183,183,2010-1,6,21,6,15,9
183,183,2010-2,6,21,21,0,15
183,183,2011-1,6,21,21,0,15
183,183,2011-2,6,22,22,0,15
183,183,2011-3,6,22,22,0,15
183,183,2012-1,6,22,22,0,15
183,183,2012-2,5,18,18,0,15
183,183,2013-1,6,22,22,0,14
183,183,2013-2,6,22,22,0,15
183,183,2013-3,6,22,22,0,15
183,183,2014-1,6,18,18,0,16
184,184,2010-1,6,21,21,0,15
184,184,2010-2,6,21,21,0,17
184,184,2011-1,6,22,22,0,16
184,184,2011-2,6,22,22,0,17
184,184,2011-3,6,22,22,0,16
184,184,2012-1,6,21,21,0,15
184,184,2012-2,6,22,22,0,14
184,184,2013-1,6,22,22,0,16
184,184,2013-2,6,22,22,0,15
184,184,2013-3,7,21,8,13,9
184,184,2014-2,4,13,13,0,15
185,185,2010-1,6,21,0,21,0
185,185,2013-3,7,19,18,1,15
185,185,2014-1,6,18,18,0,17
185,185,2014-2,5,18,18,0,15
185,185,2015-1,5,19,19,0,17
185,185,2015-2,5,19,19,0,16
186,186,2010-1,6,21,21,0,14
186,186,2010-2,6,22,8,14,10
186,186,2010-C,3,11,7,4,13
186,186,2011-1,6,22,7,15,10
186,186,2011-3,5,17,3,14,9
186,186,2012-1,6,22,11,11,11
186,186,2015-1,6,19,0,19,4
187,187,2010-1,6,21,18,3,15
187,187,2010-2,6,21,21,0,15
187,187,2011-1,6,22,22,0,14
187,187,2011-2,6,22,22,0,15
187,187,2011-3,6,22,18,4,14
187,187,2012-1,6,22,22,0,14
187,187,2012-2,6,21,17,4,15
187,187,2013-1,6,21,17,4,14
187,187,2013-3,3,12,12,0,14
187,187,2014-1,4,15,11,4,14
187,187,2014-2,5,17,17,0,15
187,187,2015-1,5,16,16,0,15
188,188,2010-1,6,21,14,7,11
188,188,2010-2,6,21,17,4,14
188,188,2011-1,6,22,0,22,2
189,189,2010-1,6,21,21,0,16
189,189,2010-2,6,21,17,4,14
189,189,2010-C,3,11,11,0,16
189,189,2011-1,6,21,17,4,12
189,189,2011-2,6,22,22,0,15
189,189,2011-3,6,21,7,14,9
189,189,2012-1,6,21,21,0,15
189,189,2012-2,6,20,20,0,15
189,189,2013-1,4,15,15,0,15
189,189,2013-2,6,22,22,0,15
189,189,2013-3,4,16,16,0,16
189,189,2014-1,4,14,10,4,15
189,189,2014-2,5,17,13,4,14
189,189,2015-2,1,4,4,0,14
190,190,2010-1,6,21,15,6,14
190,190,2010-2,6,21,3,18,4
191,191,2010-1,6,21,18,3,14
191,191,2010-2,6,21,17,4,13
191,191,2010-C,3,11,11,0,14
191,191,2011-1,6,21,13,8,11
191,191,2011-2,6,20,4,16,10
191,191,2011-3,6,21,9,12,12
191,191,2012-1,5,20,12,8,12
191,191,2012-2,5,20,16,4,14
191,191,2013-1,6,19,13,6,12
191,191,2013-2,5,18,14,4,14
191,191,2013-3,5,18,7,11,10
191,191,2014-1,4,15,11,4,12
191,191,2014-2,4,15,11,4,13
191,191,2015-1,4,15,11,4,14
191,191,2015-2,3,11,4,7,12
192,192,2010-1,6,21,12,9,13
192,192,2010-2,6,21,17,4,14
192,192,2011-2,6,21,13,8,12
192,192,2011-3,6,22,22,0,16
192,192,2012-1,6,22,14,8,12
192,192,2013-1,6,22,22,0,16
194,194,2010-1,6,21,0,21,2
195,195,2010-1,6,21,14,7,13
195,195,2010-2,5,18,11,7,13
195,195,2011-1,6,22,14,8,11
195,195,2012-1,6,22,10,12,9
195,195,2013-1,6,22,11,11,12
195,195,2013-2,6,21,18,3,12
195,195,2014-1,6,22,11,11,8
195,195,2014-2,3,12,0,12,9
195,195,2015-1,7,20,0,20,1
195,195,2015-2,5,15,0,15,0
196,196,2010-1,7,22,2,20,2
197,197,2010-1,7,22,0,22,0
198,198,2010-1,6,21,17,4,14
198,198,2010-2,6,22,22,0,15
198,198,2010-C,3,11,11,0,17
198,198,2011-1,6,22,22,0,15
198,198,2011-2,6,22,22,0,15
198,198,2011-3,6,22,18,4,14
198,198,2012-1,6,22,18,4,15
198,198,2012-2,6,22,22,0,15
198,198,2013-1,6,22,22,0,15
198,198,2013-2,6,21,21,0,15
198,198,2013-3,4,11,11,0,15
199,199,2010-1,6,21,10,11,9
199,199,2010-2,7,22,3,19,7
199,199,2010-C,3,11,0,11,0
199,199,2011-1,7,22,0,22,3
199,199,2011-3,6,21,13,8,13
199,199,2012-1,6,22,4,18,5
199,199,2012-2,6,22,0,22,3
200,200,2010-1,7,22,3,19,4
200,200,2010-2,6,19,0,19,0
200,200,2010-C,2,6,0,6,9
200,200,2011-1,5,14,0,14,0
200,200,2011-2,5,15,0,15,3
200,200,2012-1,7,22,0,22,1
201,201,2010-1,7,22,0,22,1
201,201,2010-2,7,22,0,22,0
202,202,2010-1,6,21,21,0,16
202,202,2011-1,6,21,18,3,14
202,202,2011-2,6,22,18,4,14
202,202,2013-3,6,22,14,8,11
202,202,2014-1,6,22,15,7,11
202,202,2014-2,6,22,11,11,12
202,202,2015-1,5,16,16,0,15
203,203,2010-1,6,21,21,0,15
203,203,2010-2,6,22,22,0,15
203,203,2010-C,3,11,11,0,18
203,203,2011-1,6,22,22,0,16
203,203,2011-2,6,22,22,0,15
203,203,2011-3,6,22,22,0,17
203,203,2012-1,6,22,22,0,16
203,203,2012-2,6,22,22,0,15
203,203,2013-1,6,22,22,0,16
203,203,2013-2,7,22,22,0,16
203,203,2013-3,3,8,8,0,16
204,204,2010-1,5,17,0,17,0
205,205,2010-1,6,21,17,4,15
205,205,2010-2,7,22,17,5,16
205,205,2010-C,3,11,4,7,9
205,205,2011-1,7,21,21,0,14
205,205,2011-2,6,22,18,4,15
205,205,2011-3,6,22,14,8,13
205,205,2012-1,6,22,12,10,13
205,205,2012-2,7,22,19,3,14
205,205,2013-1,7,22,22,0,14
205,205,2013-2,7,22,15,7,13
205,205,2013-3,7,22,15,7,14
205,205,2014-1,6,22,18,4,15
205,205,2014-2,6,24,21,3,15
205,205,2015-1,2,6,3,3,8
206,206,2010-1,7,22,18,4,13
206,206,2010-2,6,19,12,7,11
206,206,2011-1,5,15,6,9,12
206,206,2011-2,6,19,6,13,9
206,206,2011-3,4,13,3,10,5
206,206,2012-1,4,13,0,13,6
207,207,2010-1,7,22,22,0,16
207,207,2010-2,7,22,22,0,15
207,207,2010-C,2,6,6,0,16
207,207,2011-1,7,22,22,0,15
207,207,2011-2,6,20,20,0,15
207,207,2011-3,6,22,22,0,16
207,207,2012-1,6,19,19,0,15
207,207,2012-2,6,19,19,0,15
207,207,2013-1,7,22,22,0,15
207,207,2013-2,7,22,22,0,15
207,207,2013-3,6,19,19,0,15
208,208,2010-1,7,22,22,0,16
208,208,2010-2,7,22,22,0,16
208,208,2010-C,2,6,6,0,18
208,208,2011-1,7,22,22,0,16
208,208,2011-2,6,20,16,4,12
208,208,2011-3,5,20,20,0,16
208,208,2012-1,7,22,22,0,16
208,208,2012-2,7,22,22,0,16
208,208,2013-1,7,22,22,0,16
208,208,2013-2,7,22,22,0,15
208,208,2013-3,6,19,19,0,16
210,210,2010-1,7,22,18,4,14
211,211,2010-1,6,21,17,4,14
211,211,2010-2,6,21,0,21,1
211,211,2011-1,6,21,0,21,0
212,212,2010-1,6,21,6,15,10
212,212,2010-2,6,21,14,7,14
212,212,2010-C,3,11,11,0,15
212,212,2011-1,6,20,11,9,12
212,212,2011-2,6,21,17,4,14
212,212,2011-3,6,21,13,8,12
212,212,2012-1,6,22,18,4,13
212,212,2012-2,6,20,10,10,12
212,212,2013-1,6,21,17,4,14
212,212,2013-2,7,21,10,11,11
212,212,2013-3,7,21,9,12,13
212,212,2014-1,8,22,9,13,10
212,212,2014-2,6,22,14,8,12
212,212,2015-1,7,22,18,4,14
212,212,2015-2,6,21,21,0,15
213,213,2010-1,7,22,17,5,14
213,213,2010-2,6,22,22,0,16
213,213,2010-C,2,7,7,0,15
213,213,2011-1,7,22,22,0,15
213,213,2011-2,6,22,22,0,15
213,213,2011-3,6,22,22,0,15
213,213,2012-1,7,22,22,0,16
213,213,2012-2,8,21,21,0,16
213,213,2013-1,7,21,21,0,16
213,213,2013-2,6,22,22,0,16
213,213,2013-3,4,18,18,0,18
214,214,2010-1,7,22,22,0,16
214,214,2010-2,8,22,22,0,15
214,214,2010-C,3,11,11,0,15
214,214,2011-1,6,21,21,0,15
214,214,2011-2,5,19,7,12,12
214,214,2011-3,5,20,0,20,1
214,214,2012-1,5,20,16,4,14
214,214,2012-2,5,19,8,11,10
214,214,2013-1,6,22,14,8,14
214,214,2013-2,5,20,8,12,12
214,214,2013-3,6,22,3,19,9
214,214,2014-1,5,19,0,19,4
214,214,2014-2,5,20,12,8,13
214,214,2015-1,5,17,0,17,0
214,214,2015-2,6,21,0,21,3
215,215,2010-1,7,22,0,22,0
215,215,2011-1,7,22,9,13,10
215,215,2011-2,7,22,0,22,0
215,215,2011-3,7,22,0,22,0
216,216,2010-1,6,21,21,0,16
216,216,2010-2,6,21,21,0,16
216,216,2010-C,3,11,11,0,18
216,216,2011-1,6,22,22,0,17
216,216,2011-2,6,22,22,0,17
216,216,2011-3,6,22,22,0,16
216,216,2012-1,6,21,21,0,16
216,216,2012-2,6,22,22,0,16
216,216,2013-1,6,22,22,0,15
216,216,2013-2,7,22,22,0,16
216,216,2013-3,5,16,16,0,16
217,217,2010-1,6,21,21,0,17
217,217,2010-2,6,22,18,4,13
217,217,2010-C,3,12,12,0,16
217,217,2011-1,6,21,21,0,16
217,217,2011-2,6,22,22,0,16
217,217,2011-3,6,21,21,0,15
217,217,2012-1,6,22,22,0,16
217,217,2012-2,6,22,22,0,15
217,217,2013-1,6,22,22,0,16
217,217,2013-2,7,22,22,0,15
217,217,2013-3,4,13,13,0,15
218,218,2010-1,6,21,0,21,2
218,218,2010-2,6,21,0,21,0
218,218,2011-1,6,21,0,21,0
218,218,2011-2,6,21,3,18,10
218,218,2011-3,6,21,9,12,8
218,218,2012-1,6,21,10,11,8
218,218,2012-2,6,21,10,11,11
218,218,2013-1,6,21,12,9,12
218,218,2013-2,6,22,12,10,12
218,218,2013-3,6,22,22,0,15
218,218,2014-1,6,22,18,4,12
218,218,2014-2,6,22,19,3,14
218,218,2015-1,6,22,22,0,15
218,218,2015-2,6,22,22,0,14
219,219,2010-1,6,21,13,8,13
219,219,2010-2,6,22,22,0,15
219,219,2010-C,3,11,11,0,15
219,219,2011-1,7,22,14,8,13
219,219,2011-2,6,22,15,7,14
219,219,2011-3,6,22,15,7,12
219,219,2012-1,7,22,15,7,12
219,219,2012-2,7,21,7,14,11
219,219,2013-1,6,20,20,0,15
219,219,2013-2,7,22,16,6,14
219,219,2013-3,7,22,22,0,15
219,219,2014-1,6,22,11,11,13
219,219,2014-2,6,21,14,7,12
219,219,2015-1,5,21,21,0,15
220,220,2010-1,7,22,22,0,15
220,220,2010-2,7,22,12,10,10
220,220,2011-1,7,22,13,9,10
220,220,2011-2,7,22,7,15,8
220,220,2011-3,7,22,10,12,12
220,220,2012-1,6,21,12,9,11
220,220,2012-2,7,22,6,16,12
220,220,2013-1,5,17,11,6,11
220,220,2013-2,7,22,10,12,12
220,220,2013-3,6,19,16,3,14
220,220,2014-1,5,16,16,0,14
220,220,2014-2,7,22,10,12,13
220,220,2015-1,5,15,12,3,14
220,220,2015-2,7,21,18,3,14
221,221,2010-1,5,17,11,6,9
221,221,2010-2,6,21,6,15,8
221,221,2011-1,6,20,0,20,5
221,221,2011-2,6,21,0,21,2
222,222,2010-1,6,21,6,15,7
222,222,2011-1,6,21,14,7,13
222,222,2011-2,6,21,10,11,11
222,222,2011-3,6,20,18,2,15
222,222,2012-1,6,22,0,22,4
222,222,2012-2,5,19,15,4,12
222,222,2013-1,5,20,20,0,14
222,222,2013-2,6,22,11,11,12
222,222,2013-3,5,20,16,4,14
222,222,2014-1,6,22,10,12,13
222,222,2014-2,6,22,10,12,10
222,222,2015-2,6,22,3,19,10
223,223,2010-1,6,21,4,17,5
223,223,2010-2,6,21,3,18,4
223,223,2010-C,2,8,0,8,3
223,223,2011-1,6,21,0,21,1
223,223,2011-2,6,21,0,21,0
223,223,2011-3,6,21,13,8,9
223,223,2013-1,6,21,7,14,10
223,223,2013-2,6,21,7,14,7
223,223,2013-3,6,18,7,11,7
223,223,2014-1,3,11,7,4,11
223,223,2014-2,4,14,10,4,14
223,223,2015-1,4,16,16,0,14
223,223,2015-2,5,19,11,8,14
224,224,2010-1,7,22,22,0,15
224,224,2010-2,6,22,18,4,14
224,224,2010-C,3,11,7,4,11
224,224,2011-1,5,17,9,8,14
224,224,2011-2,5,19,19,0,15
224,224,2011-3,6,21,17,4,14
224,224,2012-1,6,22,7,15,11
224,224,2012-2,7,22,14,8,12
224,224,2013-1,7,21,21,0,15
224,224,2013-2,6,21,17,4,14
224,224,2013-3,6,21,17,4,14
224,224,2014-1,7,22,22,0,15
224,224,2014-2,3,11,11,0,15
224,224,2015-1,3,15,15,0,15
225,225,2010-1,6,21,9,12,12
225,225,2010-2,7,22,18,4,14
225,225,2010-C,3,12,12,0,14
225,225,2011-1,6,21,17,4,14
225,225,2011-2,6,22,18,4,14
225,225,2011-3,6,22,6,16,11
225,225,2012-1,6,22,18,4,14
225,225,2012-2,6,20,13,7,11
225,225,2013-1,7,22,14,8,12
225,225,2013-2,6,20,6,14,10
225,225,2013-3,6,21,17,4,12
225,225,2014-1,6,21,13,8,13
225,225,2014-2,6,21,14,7,14
225,225,2015-1,7,22,22,0,16
225,225,2015-2,4,19,19,0,16
226,226,2010-1,6,21,6,15,9
226,226,2011-1,7,22,0,22,2
227,227,2010-1,7,22,16,6,13
227,227,2010-2,7,21,14,7,11
227,227,2010-C,3,10,6,4,11
227,227,2011-1,5,19,19,0,15
227,227,2011-2,5,18,18,0,14
227,227,2011-3,6,21,13,8,9
227,227,2012-1,5,18,10,8,13
227,227,2012-2,6,21,18,3,14
227,227,2013-1,5,19,19,0,17
227,227,2013-2,6,21,17,4,14
227,227,2013-3,5,19,15,4,15
227,227,2014-1,5,18,18,0,14
227,227,2014-2,6,21,21,0,16
227,227,2015-1,4,13,13,0,15
228,228,2010-1,7,22,12,10,11
228,228,2010-2,6,19,15,4,12
228,228,2010-C,2,6,2,4,12
228,228,2011-1,6,19,19,0,15
228,228,2011-2,6,21,7,14,8
228,228,2011-3,6,20,13,7,11
228,228,2012-1,4,15,12,3,13
228,228,2012-2,5,19,8,11,12
228,228,2013-1,3,11,11,0,14
228,228,2013-2,4,15,11,4,14
228,228,2013-3,5,20,12,8,14
228,228,2014-1,5,20,16,4,15
228,228,2014-2,5,19,19,0,15
228,228,2015-1,6,20,20,0,15
228,228,2015-2,6,22,18,4,14
229,229,2010-1,7,22,0,22,0
230,230,2010-1,7,22,11,11,12
230,230,2010-2,4,14,3,11,9
230,230,2012-1,4,14,14,0,15
230,230,2012-2,6,18,18,0,14
230,230,2013-1,6,20,20,0,15
230,230,2013-2,6,22,22,0,16
230,230,2013-3,6,22,22,0,16
230,230,2014-1,6,22,22,0,17
230,230,2014-2,6,22,22,0,16
230,230,2015-1,6,22,22,0,17
230,230,2015-2,6,22,22,0,16
231,231,2010-1,7,22,18,4,13
231,231,2010-2,6,19,19,0,15
231,231,2010-C,2,7,3,4,11
231,231,2011-1,6,20,20,0,15
231,231,2011-2,6,21,21,0,16
231,231,2011-3,6,21,21,0,15
231,231,2012-1,5,19,19,0,16
231,231,2012-2,6,22,18,4,15
231,231,2013-1,6,22,22,0,16
231,231,2013-2,6,22,19,3,15
231,231,2013-3,6,22,22,0,16
231,231,2014-1,5,15,15,0,17
232,232,2010-1,7,22,0,22,2
232,232,2010-2,7,22,0,22,1
234,234,2010-1,7,22,19,3,14
234,234,2010-2,7,22,15,7,14
234,234,2011-3,6,18,9,9,11
234,234,2012-1,5,15,6,9,11
234,234,2012-2,4,13,7,6,9
234,234,2013-1,5,15,15,0,14
234,234,2013-2,6,21,14,7,11
234,234,2013-3,3,11,7,4,9
235,235,2010-1,7,22,19,3,13
235,235,2010-2,7,22,10,12,10
235,235,2010-C,3,9,6,3,10
235,235,2011-1,7,22,6,16,9
235,235,2011-2,7,22,7,15,9
235,235,2011-3,7,21,9,12,9
235,235,2012-1,3,9,3,6,5
235,235,2013-1,4,12,9,3,14
235,235,2013-2,6,19,16,3,13
235,235,2013-3,4,16,11,5,14
235,235,2014-1,6,21,21,0,15
235,235,2014-2,6,19,19,0,15
235,235,2015-1,6,19,19,0,14
235,235,2015-2,7,22,18,4,12
236,236,2010-1,7,22,17,5,13
236,236,2010-2,7,21,15,6,12
236,236,2010-C,3,9,9,0,14
236,236,2011-1,7,22,3,19,2
237,237,2010-1,6,21,17,4,14
237,237,2010-2,6,21,13,8,12
237,237,2011-1,6,21,10,11,11
237,237,2011-3,6,22,8,14,12
237,237,2012-1,6,21,6,15,9
237,237,2013-3,3,12,8,4,15
237,237,2014-1,4,15,11,4,13
237,237,2014-2,6,20,16,4,14
237,237,2015-1,5,19,19,0,15
237,237,2015-2,6,20,20,0,15
238,238,2010-1,6,21,21,0,15
238,238,2010-2,6,21,17,4,14
238,238,2011-1,6,22,0,22,9
238,238,2013-2,6,21,3,18,4
239,239,2010-1,6,21,6,15,7
240,240,2010-1,6,21,17,4,12
240,240,2010-2,6,21,14,7,13
240,240,2010-C,3,12,0,12,2
240,240,2011-1,6,22,0,22,1
240,240,2011-2,6,22,0,22,1
240,240,2011-3,6,22,0,22,2
240,240,2012-1,6,21,0,21,1
240,240,2012-2,6,22,3,19,7
240,240,2013-1,6,22,0,22,1
240,240,2013-2,6,22,0,22,6
240,240,2013-3,5,17,7,10,8
240,240,2014-1,5,17,0,17,1
240,240,2014-2,6,20,0,20,0
240,240,2015-1,6,19,15,4,15
240,240,2015-2,4,15,15,0,15
241,241,2010-1,6,21,21,0,16
241,241,2010-2,6,22,14,8,10
241,241,2010-C,3,11,11,0,16
241,241,2011-1,7,22,19,3,14
241,241,2011-2,6,22,22,0,14
241,241,2011-3,6,22,22,0,14
241,241,2012-1,6,22,22,0,15
241,241,2012-2,6,22,22,0,15
241,241,2013-1,6,21,21,0,15
241,241,2013-2,6,22,22,0,15
241,241,2013-3,6,20,20,0,15
242,242,2010-1,6,21,17,4,14
242,242,2010-2,5,18,14,4,12
242,242,2010-C,2,7,7,0,15
242,242,2011-1,6,22,18,4,15
242,242,2011-3,5,18,14,4,11
242,242,2012-1,6,22,18,4,15
242,242,2012-2,6,22,22,0,15
242,242,2013-1,6,22,18,4,13
242,242,2013-2,6,22,22,0,14
242,242,2013-3,6,22,18,4,13
242,242,2014-1,6,22,18,4,15
242,242,2015-1,6,22,22,0,15
242,242,2015-2,3,8,8,0,17
243,243,2010-1,6,21,0,21,3
244,244,2010-1,6,21,21,0,14
244,244,2010-2,6,21,21,0,14
244,244,2011-1,6,22,14,8,12
244,244,2011-2,6,21,9,12,11
244,244,2011-3,6,21,7,14,8
244,244,2012-1,6,21,11,10,9
244,244,2012-2,5,20,4,16,11
244,244,2013-1,6,22,14,8,13
244,244,2013-2,5,20,12,8,13
244,244,2013-3,4,15,15,0,14
244,244,2014-1,6,22,18,4,13
244,244,2014-2,6,22,22,0,15
244,244,2015-1,6,22,22,0,16
244,244,2015-2,8,26,23,3,15
245,245,2010-1,6,21,21,0,15
245,245,2010-2,6,21,17,4,13
245,245,2010-C,2,7,3,4,7
245,245,2011-1,6,22,22,0,15
245,245,2011-2,6,21,21,0,15
245,245,2011-3,6,22,18,4,14
245,245,2012-1,6,22,18,4,15
245,245,2012-2,6,22,22,0,16
245,245,2013-1,6,22,22,0,15
245,245,2013-2,6,21,18,3,14
245,245,2013-3,6,22,18,4,12
245,245,2014-1,5,16,16,0,15
246,246,2010-1,6,21,21,0,15
246,246,2010-2,6,22,22,0,15
246,246,2010-C,2,8,8,0,17
246,246,2011-1,6,22,22,0,16
246,246,2011-2,6,22,22,0,16
246,246,2011-3,2,8,8,0,15
246,246,2012-1,6,21,21,0,16
246,246,2012-2,7,22,22,0,16
246,246,2013-1,6,22,22,0,15
246,246,2013-2,6,22,22,0,15
246,246,2013-3,8,26,26,0,16
246,246,2014-1,1,3,3,0,16
247,247,2010-1,6,21,17,4,14
247,247,2010-2,6,21,17,4,13
247,247,2011-1,6,22,8,14,10
247,247,2011-2,6,21,6,15,13
247,247,2011-3,6,20,4,16,12
247,247,2012-1,4,14,10,4,13
247,247,2012-2,6,22,3,19,9
247,247,2013-1,6,21,10,11,11
247,247,2013-2,4,15,12,3,12
247,247,2013-3,5,20,16,4,13
247,247,2015-1,4,15,15,0,14
247,247,2015-2,5,15,12,3,15
248,248,2010-1,6,21,17,4,15
248,248,2010-2,6,21,14,7,11
248,248,2013-1,6,22,10,12,7
249,249,2010-1,6,21,21,0,17
249,249,2010-2,6,21,21,0,17
249,249,2011-1,7,26,26,0,16
249,249,2011-2,6,22,22,0,17
249,249,2011-3,6,22,22,0,17
249,249,2012-1,6,22,22,0,17
249,249,2012-2,6,22,22,0,16
249,249,2013-1,6,22,22,0,17
249,249,2013-2,7,22,22,0,17
249,249,2013-3,5,16,16,0,17
250,250,2010-1,6,21,9,12,12
250,250,2010-2,7,22,17,5,13
250,250,2011-1,5,17,1,16,0
250,250,2011-3,4,16,0,16,1
250,250,2012-1,4,16,0,16,5
250,250,2013-1,5,19,0,19,1
251,251,2010-1,6,20,20,0,17
251,251,2010-2,6,22,15,7,12
251,251,2010-C,3,11,11,0,16
251,251,2011-1,7,22,12,10,13
251,251,2011-2,7,21,13,8,12
251,251,2011-3,7,22,15,7,15
251,251,2012-1,6,22,18,4,13
251,251,2012-2,7,22,14,8,13
251,251,2013-1,6,20,17,3,16
251,251,2013-2,5,22,12,10,13
251,251,2013-3,5,17,17,0,15
252,252,2010-1,6,21,17,4,13
252,252,2010-2,7,22,18,4,14
252,252,2010-C,3,11,8,3,13
252,252,2011-1,5,20,20,0,15
252,252,2011-2,6,22,22,0,15
252,252,2011-3,7,22,18,4,14
252,252,2012-1,7,22,22,0,15
252,252,2012-2,7,22,18,4,14
252,252,2013-1,6,20,20,0,15
252,252,2013-2,7,22,19,3,15
252,252,2013-3,7,22,22,0,16
252,252,2014-1,2,12,4,8,9
252,252,2015-1,1,8,8,0,15
253,253,2010-1,7,22,7,15,10
253,253,2010-2,6,21,21,0,14
253,253,2010-C,3,12,12,0,15
253,253,2011-1,6,20,4,16,11
253,253,2011-2,6,20,17,3,14
253,253,2011-3,6,21,14,7,11
253,253,2012-1,4,14,14,0,15
253,253,2012-2,7,22,16,6,13
253,253,2013-1,7,21,10,11,13
253,253,2013-2,6,21,11,10,14
253,253,2013-3,7,22,15,7,11
253,253,2014-1,7,22,17,5,14
253,253,2014-2,7,22,22,0,15
253,253,2015-1,6,20,13,7,13
253,253,2015-2,3,11,4,7,12
254,254,2010-1,6,21,21,0,16
254,254,2010-2,6,22,22,0,17
254,254,2010-C,3,11,11,0,17
254,254,2011-1,8,25,25,0,17
254,254,2011-2,7,25,25,0,16
254,254,2011-3,7,21,21,0,18
254,254,2012-1,7,22,22,0,17
254,254,2012-2,7,25,25,0,18
254,254,2013-1,9,25,25,0,17
254,254,2013-2,4,19,19,0,16
255,255,2010-1,7,21,21,0,16
255,255,2010-2,7,21,21,0,14
255,255,2010-C,3,11,11,0,15
255,255,2011-1,6,22,22,0,14
255,255,2011-2,7,21,10,11,10
255,255,2011-3,6,22,22,0,15
255,255,2012-1,7,22,19,3,14
255,255,2012-2,7,22,3,19,4
255,255,2013-1,6,21,17,4,13
255,255,2013-2,4,18,6,12,11
255,255,2013-3,4,18,10,8,11
255,255,2014-1,3,15,3,12,8
255,255,2014-2,2,12,12,0,14
256,256,2010-1,7,22,9,13,7
256,256,2010-2,6,18,0,18,0
256,256,2010-C,3,10,0,10,0
256,256,2011-1,6,18,0,18,0
256,256,2012-1,7,22,0,22,2
256,256,2012-2,7,22,3,19,4
256,256,2013-1,3,12,4,8,10
256,256,2013-2,4,14,0,14,1
257,257,2010-1,6,21,17,4,15
257,257,2010-2,7,22,22,0,16
257,257,2010-C,3,11,11,0,17
257,257,2011-1,6,21,21,0,15
257,257,2011-2,6,21,21,0,16
257,257,2011-3,6,22,22,0,15
257,257,2012-1,8,22,19,3,15
257,257,2012-2,7,22,22,0,15
257,257,2013-1,7,22,22,0,16
257,257,2013-2,6,22,22,0,16
257,257,2013-3,4,17,17,0,15
258,258,2010-1,6,21,17,4,14
258,258,2010-2,6,22,11,11,13
258,258,2010-C,3,11,7,4,13
258,258,2011-1,7,21,20,1,14
258,258,2011-2,7,21,17,4,14
258,258,2011-3,6,22,14,8,13
258,258,2012-1,6,22,18,4,13
258,258,2012-2,7,21,14,7,13
258,258,2013-1,6,21,17,4,13
258,258,2013-2,7,22,12,10,12
258,258,2013-3,6,22,11,11,14
258,258,2014-1,6,21,17,4,15
258,258,2014-2,4,11,7,4,13
258,258,2015-1,4,15,11,4,13
258,258,2015-2,5,23,19,4,14
259,259,2010-1,6,21,21,0,15
259,259,2010-2,6,20,20,0,15
259,259,2010-C,3,11,7,4,9
259,259,2011-1,6,21,17,4,14
259,259,2011-2,6,21,14,7,14
259,259,2011-3,6,21,13,8,14
259,259,2012-1,6,22,15,7,13
259,259,2012-2,8,22,8,14,10
259,259,2013-1,6,20,12,8,14
259,259,2013-2,6,21,6,15,10
259,259,2013-3,7,22,17,5,13
259,259,2014-1,7,22,14,8,12
259,259,2014-2,7,21,10,11,13
259,259,2015-1,5,15,4,11,11
260,260,2010-1,6,21,13,8,12
260,260,2010-2,6,19,3,16,4
260,260,2010-C,3,11,7,4,11
260,260,2011-1,5,16,4,12,8
260,260,2011-2,6,20,12,8,13
260,260,2011-3,5,20,4,16,10
260,260,2012-1,5,19,8,11,8
260,260,2012-2,5,18,0,18,5
260,260,2013-2,6,22,11,11,11
260,260,2013-3,6,20,0,20,2
261,261,2010-1,7,22,3,19,7
262,262,2010-1,7,22,14,8,12
262,262,2010-2,7,22,5,17,9
262,262,2010-C,3,11,4,7,5
262,262,2011-1,5,17,14,3,14
262,262,2011-2,6,21,3,18,9
262,262,2011-3,4,15,7,8,12
262,262,2012-1,5,16,12,4,14
262,262,2013-1,5,18,15,3,14
262,262,2013-2,5,17,17,0,14
262,262,2013-3,5,19,8,11,11
262,262,2014-1,3,11,4,7,13
262,262,2014-2,5,18,15,3,14
262,262,2015-2,5,15,7,8,13
263,263,2010-1,7,22,18,4,13
263,263,2010-2,6,19,2,17,9
263,263,2010-C,2,7,3,4,10
264,264,2011-1,7,22,22,0,16
264,264,2011-2,7,22,22,0,15
264,264,2011-3,7,22,22,0,15
264,264,2012-1,7,22,22,0,16
264,264,2012-2,4,17,17,0,16
264,264,2013-1,7,22,22,0,16
264,264,2013-2,7,22,18,4,15
264,264,2013-3,6,19,19,0,15
264,264,2014-1,7,22,15,7,14
264,264,2014-2,6,19,19,0,16
264,264,2015-1,5,17,17,0,15
265,265,2010-1,7,22,19,3,13
265,265,2011-1,7,22,15,7,12
265,265,2011-2,7,22,13,9,9
265,265,2012-1,7,22,0,22,0
265,265,2015-1,6,20,20,0,15
266,266,2010-1,7,22,0,22,0
267,267,2010-1,7,22,15,7,11
267,267,2011-2,6,20,13,7,10
267,267,2011-3,6,20,7,13,6
267,267,2012-1,6,20,13,7,9
267,267,2013-1,6,18,0,18,3
267,267,2014-1,6,19,0,19,2
267,267,2014-2,5,15,0,15,5
268,268,2010-1,7,22,19,3,13
268,268,2010-2,7,22,22,0,15
268,268,2010-C,4,12,12,0,15
268,268,2011-1,7,22,3,19,10
268,268,2011-2,7,22,16,6,11
268,268,2011-3,6,20,17,3,14
268,268,2012-1,5,20,20,0,16
268,268,2012-2,7,22,22,0,15
268,268,2013-1,7,22,19,3,14
268,268,2013-2,7,22,13,9,13
268,268,2013-3,7,21,18,3,14
268,268,2014-1,6,19,16,3,13
268,268,2014-2,4,12,9,3,12
268,268,2015-1,3,9,3,6,12
268,268,2015-2,2,6,6,0,14
269,269,2010-1,7,22,22,0,17
269,269,2010-2,7,22,22,0,17
269,269,2010-C,2,6,6,0,18
269,269,2011-1,8,25,25,0,17
269,269,2011-2,4,13,13,0,17
269,269,2011-3,5,20,20,0,17
269,269,2012-1,7,22,22,0,16
269,269,2012-2,7,22,22,0,17
269,269,2013-1,7,22,22,0,16
269,269,2013-2,7,22,22,0,17
269,269,2013-3,6,19,19,0,16
270,270,2010-1,7,22,22,0,17
270,270,2010-2,7,22,22,0,15
270,270,2010-C,2,6,6,0,15
270,270,2011-1,7,22,22,0,15
270,270,2011-2,4,13,13,0,15
270,270,2012-1,5,20,20,0,16
270,270,2012-2,7,22,22,0,17
270,270,2013-1,7,22,22,0,17
270,270,2013-2,7,22,22,0,16
270,270,2013-3,6,19,19,0,15
270,270,2014-1,8,25,25,0,16
271,271,2010-1,7,22,18,4,16
271,271,2010-C,4,12,9,3,14
271,271,2011-1,7,22,12,10,8
271,271,2011-2,7,22,0,22,2
272,272,2010-1,6,21,10,11,12
272,272,2010-2,7,22,0,22,6
272,272,2010-C,2,8,0,8,7
272,272,2011-1,7,22,0,22,2
272,272,2011-2,7,22,3,19,2
272,272,2011-3,6,19,7,12,12
272,272,2012-1,6,22,3,19,6
272,272,2012-2,6,22,0,22,2
272,272,2013-1,6,22,3,19,7
272,272,2013-2,6,20,5,15,7
272,272,2013-3,6,20,16,4,14
272,272,2014-1,6,19,4,15,10
272,272,2014-2,5,19,0,19,5
272,272,2015-1,5,19,0,19,7
272,272,2015-2,5,18,0,18,2
273,273,2010-1,6,21,9,12,11
273,273,2010-2,6,21,9,12,9
273,273,2011-1,4,16,4,12,7
274,274,2010-1,7,22,0,22,0
275,275,2010-1,6,21,13,8,15
275,275,2010-2,6,21,18,3,15
275,275,2010-C,3,11,11,0,17
275,275,2011-1,6,22,18,4,14
275,275,2011-2,6,22,22,0,15
275,275,2011-3,6,22,15,7,12
275,275,2012-1,6,21,21,0,15
275,275,2012-2,5,17,17,0,15
275,275,2013-1,6,22,18,4,14
275,275,2013-2,6,22,22,0,15
275,275,2013-3,6,21,17,4,15
275,275,2014-1,4,14,14,0,15
275,275,2014-2,3,10,6,4,14
275,275,2015-1,1,4,4,0,15
276,276,2010-1,6,21,10,11,12
276,276,2010-2,6,21,3,18,2
276,276,2012-1,6,21,7,14,9
276,276,2012-2,6,22,0,22,8
276,276,2013-1,6,22,3,19,6
276,276,2013-2,6,22,7,15,9
276,276,2013-3,6,18,11,7,12
276,276,2014-1,6,19,0,19,9
276,276,2014-2,6,19,0,19,9
276,276,2015-1,6,19,6,13,7
277,277,2010-1,6,21,0,21,0
278,278,2010-1,7,22,9,13,12
278,278,2010-2,6,18,11,7,9
278,278,2010-C,1,4,0,4,11
278,278,2011-1,6,18,14,4,11
278,278,2011-2,6,21,0,21,1
278,278,2011-3,6,21,3,18,6
279,279,2010-1,6,21,3,18,8
279,279,2010-2,7,22,0,22,5
280,280,2010-1,7,22,0,22,2
281,281,2010-1,7,22,16,6,15
281,281,2010-2,7,21,21,0,17
281,281,2010-C,3,10,10,0,15
281,281,2011-1,7,23,23,0,16
281,281,2011-2,6,22,22,0,17
281,281,2011-3,7,26,26,0,17
281,281,2012-1,7,26,26,0,17
281,281,2012-2,6,21,21,0,17
281,281,2013-1,5,19,19,0,18
281,281,2013-2,5,18,18,0,18
281,281,2013-3,5,15,15,0,17
282,282,2010-1,6,21,21,0,16
282,282,2010-2,6,21,18,3,16
282,282,2011-1,6,22,14,8,14
282,282,2011-2,6,21,18,3,14
282,282,2012-1,6,22,22,0,15
282,282,2012-2,6,22,22,0,15
282,282,2013-1,6,21,21,0,15
282,282,2013-2,6,22,22,0,15
282,282,2013-3,6,22,22,0,15
282,282,2014-1,6,22,22,0,15
282,282,2014-2,5,14,14,0,15
283,283,2010-1,7,22,18,4,14
283,283,2010-2,7,22,22,0,16
283,283,2010-C,3,11,11,0,15
283,283,2011-1,6,20,20,0,17
283,283,2011-2,5,17,17,0,18
283,283,2011-3,6,22,22,0,17
283,283,2012-1,7,26,26,0,17
283,283,2012-2,6,22,22,0,17
283,283,2013-1,6,22,22,0,17
283,283,2013-2,6,22,22,0,17
283,283,2013-3,5,15,15,0,16
284,284,2010-1,7,22,0,22,0
285,285,2010-1,7,23,23,0,17
285,285,2010-2,7,22,18,4,12
285,285,2010-C,4,12,12,0,17
285,285,2011-1,6,21,17,4,12
285,285,2011-2,6,20,16,4,11
285,285,2011-3,6,20,20,0,14
285,285,2012-1,6,21,21,0,15
285,285,2012-2,7,22,22,0,15
285,285,2013-1,5,17,17,0,16
285,285,2013-2,3,11,11,0,16
286,286,2010-1,6,21,0,21,0
287,287,2010-1,7,22,0,22,0
288,288,2010-1,6,21,14,7,14
288,288,2010-2,6,22,6,16,5
288,288,2010-C,3,11,7,4,11
288,288,2011-1,6,22,0,22,0
288,288,2011-3,6,22,8,14,7
288,288,2012-1,6,21,21,0,15
288,288,2012-2,6,21,21,0,15
288,288,2013-1,6,22,22,0,16
288,288,2013-2,6,21,21,0,15
288,288,2013-3,6,22,22,0,15
288,288,2014-1,6,22,22,0,16
288,288,2014-2,5,20,16,4,14
288,288,2015-1,7,24,20,4,15
288,288,2015-2,1,4,4,0,14
289,289,2010-1,7,22,6,16,11
289,289,2010-2,2,6,6,0,16
289,289,2011-1,5,20,8,12,12
289,289,2011-2,3,12,4,8,12
289,289,2015-2,6,20,13,7,13
290,290,2010-1,6,21,3,18,7
291,291,2010-1,6,21,17,4,13
291,291,2010-2,6,21,11,10,11
291,291,2010-C,3,11,7,4,9
291,291,2011-1,6,22,7,15,7
291,291,2011-2,6,22,14,8,13
291,291,2011-3,6,22,4,18,10
291,291,2012-1,6,22,11,11,11
291,291,2012-2,6,22,4,18,3
291,291,2013-1,6,22,6,16,9
291,291,2013-2,5,18,0,18,6
291,291,2013-3,6,22,10,12,9
291,291,2014-1,6,22,18,4,14
291,291,2014-2,6,22,8,14,12
291,291,2015-1,6,22,8,14,10
291,291,2015-2,6,22,6,16,5
292,292,2010-1,6,21,21,0,15
292,292,2011-1,6,21,7,14,10
292,292,2011-2,6,22,7,15,9
292,292,2011-3,6,21,13,8,11
292,292,2012-1,6,21,2,19,11
292,292,2013-1,2,8,8,0,14
292,292,2013-2,6,22,18,4,14
292,292,2013-3,6,22,3,19,11
292,292,2014-2,6,18,11,7,12
292,292,2015-1,5,19,19,0,14
292,292,2015-2,5,20,16,4,14
293,293,2010-1,6,21,14,7,13
293,293,2010-2,6,21,18,3,13
293,293,2010-C,3,11,7,4,11
293,293,2011-1,6,22,22,0,16
293,293,2011-2,6,22,14,8,11
293,293,2011-3,6,21,18,3,14
293,293,2012-1,6,22,18,4,13
293,293,2012-2,6,21,18,3,14
293,293,2013-1,6,22,22,0,15
293,293,2013-2,6,22,10,12,13
293,293,2013-3,6,22,18,4,12
293,293,2014-1,6,22,22,0,15
293,293,2014-2,5,15,15,0,15
294,294,2010-1,6,21,21,0,14
294,294,2010-2,6,22,14,8,11
294,294,2010-C,3,11,11,0,15
294,294,2011-1,6,22,22,0,14
294,294,2011-2,6,22,4,18,10
294,294,2011-3,6,22,19,3,14
294,294,2012-1,6,21,18,3,13
294,294,2012-2,6,21,21,0,16
294,294,2013-1,6,22,22,0,15
294,294,2013-2,6,22,22,0,15
294,294,2013-3,6,21,18,3,14
294,294,2014-1,8,24,24,0,15
295,295,2010-1,6,21,4,17,5
295,295,2010-2,6,21,13,8,11
295,295,2010-C,1,4,0,4,0
295,295,2011-1,6,21,10,11,11
295,295,2011-2,6,22,0,22,1
296,296,2010-1,6,21,17,4,14
296,296,2010-2,3,11,11,0,18
297,297,2010-1,6,21,21,0,16
297,297,2010-2,6,21,17,4,12
297,297,2010-C,3,11,11,0,19
297,297,2011-1,6,21,13,8,12
297,297,2011-2,6,21,17,4,15
297,297,2011-3,6,22,18,4,12
297,297,2012-1,6,22,10,12,9
297,297,2012-2,5,20,16,4,14
297,297,2013-1,6,22,19,3,15
297,297,2013-2,3,12,12,0,14
297,297,2013-3,6,22,22,0,15
297,297,2014-1,6,22,18,4,14
297,297,2014-2,7,22,22,0,15
298,298,2010-1,6,21,13,8,12
298,298,2010-2,6,21,7,14,10
298,298,2010-C,3,11,3,8,10
298,298,2011-1,6,21,13,8,13
298,298,2011-2,6,21,14,7,13
298,298,2011-3,6,21,14,7,10
298,298,2012-1,6,22,7,15,9
298,298,2012-2,4,15,3,12,7
298,298,2013-1,4,15,3,12,11
298,298,2013-2,3,12,8,4,12
298,298,2013-3,6,22,19,3,13
298,298,2014-1,6,22,12,10,13
298,298,2014-2,6,22,14,8,12
298,298,2015-1,6,21,11,10,14
298,298,2015-2,5,18,11,7,11
300,300,2010-1,6,21,13,8,11
300,300,2010-2,6,19,19,0,15
300,300,2010-C,3,11,11,0,16
300,300,2011-1,6,21,21,0,15
300,300,2011-2,6,22,22,0,15
300,300,2011-3,6,21,14,7,14
300,300,2012-1,7,22,15,7,13
300,300,2012-2,7,21,21,0,14
300,300,2013-1,7,22,19,3,14
300,300,2013-2,7,22,22,0,15
300,300,2013-3,6,22,22,0,15
300,300,2014-1,4,17,9,8,14
300,300,2014-2,1,8,8,0,16
301,301,2010-1,7,22,22,0,16
301,301,2010-2,6,22,22,0,16
301,301,2010-C,3,11,11,0,16
301,301,2011-1,6,20,8,12,10
301,301,2011-2,6,19,19,0,14
301,301,2011-3,6,22,19,3,12
301,301,2012-1,8,22,17,5,13
301,301,2012-2,7,21,17,4,13
301,301,2013-1,6,21,21,0,15
301,301,2013-2,7,21,16,5,14
301,301,2013-3,7,22,22,0,14
301,301,2014-1,5,22,10,12,12
301,301,2014-2,2,12,0,12,2
301,301,2015-1,2,12,0,12,4
301,301,2015-2,2,12,0,12,1
302,302,2010-1,6,21,13,8,12
302,302,2010-2,6,21,17,4,12
302,302,2011-1,4,13,13,0,14
302,302,2011-2,6,21,9,12,11
302,302,2011-3,5,20,12,8,11
302,302,2012-1,5,19,16,3,14
302,302,2012-2,6,21,17,4,12
302,302,2013-1,6,21,17,4,14
302,302,2013-2,8,22,12,10,12
302,302,2013-3,6,20,9,11,11
302,302,2014-1,7,22,14,8,13
302,302,2014-2,6,22,22,0,15
302,302,2015-1,6,21,21,0,15
302,302,2015-2,6,24,24,0,16
303,303,2010-1,6,21,0,21,0
303,303,2010-2,6,21,3,18,3
304,304,2010-1,7,22,21,1,16
304,304,2010-2,7,22,17,5,14
305,305,2010-1,6,21,17,4,13
305,305,2010-2,6,21,13,8,13
305,305,2010-C,3,11,8,3,13
305,305,2011-1,7,22,21,1,14
305,305,2011-2,6,22,18,4,13
305,305,2011-3,7,22,2,20,9
305,305,2012-1,6,22,22,0,14
305,305,2012-2,6,22,14,8,12
305,305,2013-1,7,21,17,4,15
305,305,2013-2,6,20,17,3,15
305,305,2013-3,7,22,18,4,15
305,305,2014-1,6,22,22,0,14
305,305,2014-2,5,21,21,0,17
305,305,2015-1,2,6,6,0,15
306,306,2010-1,6,21,9,12,11
306,306,2010-2,6,22,22,0,15
306,306,2010-C,3,11,11,0,16
306,306,2011-1,7,21,10,11,12
306,306,2011-2,6,21,21,0,15
306,306,2011-3,6,21,21,0,14
306,306,2012-1,7,22,13,9,12
306,306,2012-2,7,22,22,0,15
306,306,2013-1,7,22,22,0,16
306,306,2013-2,6,19,19,0,15
306,306,2013-3,6,22,18,4,15
306,306,2014-1,6,20,13,7,13
306,306,2014-2,3,15,15,0,16
307,307,2010-1,7,22,10,12,9
307,307,2010-2,7,22,22,0,17
307,307,2011-1,5,16,16,0,14
307,307,2011-2,5,20,20,0,16
307,307,2011-3,6,22,22,0,14
307,307,2012-1,6,21,13,8,11
307,307,2012-2,7,22,22,0,15
307,307,2013-1,7,22,22,0,16
307,307,2013-2,7,22,22,0,15
307,307,2013-3,7,22,22,0,16
307,307,2014-1,6,25,17,8,14
307,307,2014-2,1,8,8,0,18
308,308,2010-1,6,21,11,10,11
308,308,2010-2,7,22,0,22,2
308,308,2010-C,2,8,0,8,5
309,309,2012-2,7,22,22,0,16
310,310,2010-1,7,22,17,5,14
310,310,2010-2,6,21,6,15,8
310,310,2011-1,6,20,16,4,13
310,310,2011-2,5,19,0,19,6
310,310,2011-3,5,19,19,0,14
310,310,2012-1,6,20,0,20,2
310,310,2012-2,6,20,20,0,15
310,310,2013-1,6,22,10,12,11
310,310,2013-2,6,20,0,20,3
310,310,2013-3,6,22,19,3,13
310,310,2014-1,8,22,15,7,13
310,310,2014-2,7,22,16,6,13
310,310,2015-1,7,22,16,6,14
310,310,2015-2,6,22,22,0,16
311,311,2010-1,6,21,21,0,15
311,311,2010-2,6,22,18,4,14
311,311,2010-C,3,11,7,4,10
311,311,2011-1,7,22,17,5,14
311,311,2011-2,7,20,16,4,13
311,311,2011-3,6,22,14,8,14
311,311,2012-1,7,21,14,7,14
311,311,2012-2,6,21,13,8,14
311,311,2013-1,6,22,14,8,13
311,311,2013-2,6,21,14,7,12
311,311,2013-3,7,21,21,0,15
311,311,2014-1,6,21,21,0,15
311,311,2014-2,6,26,26,0,16
312,312,2010-1,6,21,13,8,11
312,312,2010-2,6,22,18,4,13
312,312,2010-C,3,11,7,4,14
312,312,2011-1,6,20,19,1,15
312,312,2011-2,6,22,22,0,16
312,312,2011-3,7,21,21,0,15
312,312,2012-1,7,22,15,7,13
312,312,2012-2,7,21,21,0,15
312,312,2013-1,7,22,22,0,15
312,312,2013-2,7,22,13,9,12
312,312,2013-3,7,22,22,0,16
312,312,2014-1,3,12,12,0,14
312,312,2014-2,2,11,11,0,14
313,313,2010-1,6,21,3,18,5
313,313,2010-2,7,22,13,9,12
313,313,2011-1,6,19,3,16,9
313,313,2011-2,5,16,3,13,7
314,314,2010-1,6,21,0,21,0
314,314,2012-2,7,22,21,1,16
314,314,2013-1,6,21,21,0,17
314,314,2013-2,7,22,22,0,15
314,314,2013-3,6,22,18,4,14
314,314,2014-1,6,21,21,0,15
314,314,2014-2,7,22,18,4,13
314,314,2015-1,7,21,21,0,15
314,314,2015-2,7,22,22,0,16
315,315,2010-1,7,22,22,0,15
316,316,2010-1,7,22,20,2,15
316,316,2010-2,7,22,17,5,14
316,316,2010-C,3,9,0,9,2
316,316,2011-1,7,21,19,2,14
316,316,2011-2,7,22,16,6,12
316,316,2011-3,6,20,13,7,11
316,316,2012-1,6,22,19,3,14
316,316,2012-2,6,22,22,0,14
316,316,2013-1,6,21,14,7,14
316,316,2013-2,6,21,14,7,14
316,316,2013-3,6,22,14,8,13
316,316,2014-1,5,18,10,8,11
316,316,2014-2,5,20,20,0,15
316,316,2015-1,6,19,19,0,15
317,317,2010-1,7,22,7,15,9
318,318,2010-1,7,22,17,5,13
318,318,2010-2,7,21,7,14,7
318,318,2010-C,3,9,3,6,9
318,318,2011-1,7,21,3,18,4
318,318,2011-2,7,21,15,6,13
318,318,2011-3,7,22,4,18,9
318,318,2012-1,4,12,9,3,14
318,318,2012-2,5,17,3,14,5
319,319,2010-1,7,22,16,6,12
319,319,2010-2,7,22,0,22,0
319,319,2010-C,3,9,6,3,10
319,319,2011-1,7,22,6,16,7
319,319,2011-2,7,22,3,19,2
319,319,2011-3,7,22,0,22,1
319,319,2012-1,7,22,6,16,4
319,319,2012-2,7,22,7,15,8
319,319,2013-1,5,16,3,13,9
320,320,2010-1,7,22,22,0,17
320,320,2010-2,7,22,19,3,14
320,320,2010-C,2,6,3,3,8
320,320,2011-1,6,19,9,10,12
320,320,2011-2,6,19,6,13,6
320,320,2011-3,6,20,7,13,12
320,320,2012-1,6,19,3,16,5
320,320,2012-2,6,20,11,9,11
320,320,2013-1,4,12,6,6,11
320,320,2013-2,3,10,7,3,10
320,320,2013-3,7,21,15,6,12
320,320,2014-1,6,20,12,8,10
320,320,2014-2,6,21,3,18,6
320,320,2015-1,6,21,9,12,8
320,320,2015-2,6,21,6,15,6
321,321,2010-1,7,22,22,0,16
321,321,2010-2,7,22,22,0,15
321,321,2010-C,3,9,9,0,14
321,321,2011-1,7,22,10,12,13
321,321,2011-2,7,22,22,0,14
321,321,2011-3,5,20,17,3,15
321,321,2012-1,6,19,19,0,15
321,321,2012-2,6,20,20,0,14
321,321,2013-1,6,18,15,3,14
321,321,2013-2,7,22,15,7,13
321,321,2013-3,7,22,19,3,14
321,321,2014-1,8,25,25,0,15
322,322,2010-1,7,22,22,0,15
322,322,2010-2,7,22,22,0,16
322,322,2010-C,3,9,9,0,16
322,322,2011-1,7,22,19,3,14
322,322,2011-2,6,20,20,0,15
322,322,2011-3,5,20,20,0,16
322,322,2012-1,6,18,18,0,15
322,322,2012-2,7,22,19,3,15
322,322,2013-1,7,22,22,0,15
322,322,2013-2,6,19,19,0,15
322,322,2013-3,6,19,19,0,15
322,322,2014-1,2,6,6,0,16
323,323,2010-1,7,22,22,0,16
323,323,2010-2,7,22,22,0,16
323,323,2010-C,2,6,6,0,15
323,323,2011-1,7,22,22,0,15
323,323,2011-2,6,20,16,4,12
323,323,2011-3,5,20,17,3,13
323,323,2012-1,7,22,22,0,15
323,323,2012-2,7,22,22,0,16
323,323,2013-1,7,22,18,4,14
323,323,2013-2,7,22,19,3,16
323,323,2013-3,7,22,22,0,15
323,323,2014-1,2,7,7,0,16
324,324,2010-1,7,22,22,0,17
324,324,2010-2,7,22,22,0,17
324,324,2010-C,3,9,9,0,16
324,324,2011-1,7,22,22,0,16
324,324,2011-2,4,13,13,0,17
324,324,2011-3,5,20,20,0,17
324,324,2012-1,7,22,22,0,17
324,324,2012-2,7,22,22,0,17
324,324,2013-1,7,22,22,0,16
324,324,2013-2,7,22,22,0,16
324,324,2013-3,6,19,19,0,15
325,325,2010-1,7,22,22,0,18
325,325,2010-2,7,22,22,0,17
325,325,2010-C,3,9,9,0,18
325,325,2011-1,7,22,22,0,17
325,325,2011-2,4,13,13,0,18
325,325,2011-3,4,17,17,0,19
325,325,2012-1,7,22,22,0,18
325,325,2012-2,7,22,22,0,17
325,325,2013-1,7,22,22,0,17
325,325,2013-2,5,17,17,0,17
325,325,2014-1,6,18,18,0,18
326,326,2010-1,7,22,0,22,0
326,326,2010-2,7,22,0,22,0
326,326,2011-3,7,22,22,0,15
326,326,2012-1,7,22,19,3,13
326,326,2012-2,7,22,19,3,14
326,326,2013-1,6,19,19,0,16
326,326,2013-2,4,15,15,0,16
326,326,2013-3,6,20,17,3,14
326,326,2014-1,6,21,17,4,15
326,326,2014-2,7,22,19,3,13
326,326,2015-1,7,22,12,10,11
327,327,2010-1,7,22,15,7,10
327,327,2010-2,6,20,10,10,10
327,327,2010-C,2,6,3,3,15
327,327,2011-1,7,22,6,16,8
327,327,2011-2,7,22,3,19,4
327,327,2011-3,6,19,0,19,1
327,327,2012-2,5,16,4,12,8
327,327,2013-1,5,16,13,3,12
327,327,2013-2,5,15,3,12,6
327,327,2013-3,6,19,9,10,7
327,327,2014-1,5,16,3,13,6
327,327,2014-2,4,12,8,4,12
327,327,2015-1,3,12,12,0,18
327,327,2015-2,4,15,8,7,12
328,328,2010-1,7,22,22,0,16
328,328,2010-2,7,22,22,0,15
328,328,2011-1,7,22,22,0,15
328,328,2011-2,7,22,22,0,15
328,328,2011-3,5,20,20,0,16
328,328,2012-1,7,22,22,0,16
328,328,2012-2,7,22,22,0,16
328,328,2013-1,7,22,22,0,16
328,328,2013-2,7,22,22,0,15
328,328,2013-3,6,19,19,0,16
329,329,2010-1,6,21,21,0,15
329,329,2010-2,6,21,21,0,16
329,329,2010-C,2,7,7,0,19
329,329,2011-1,6,22,22,0,17
329,329,2011-2,6,20,20,0,16
329,329,2011-3,6,22,22,0,16
329,329,2012-1,6,22,22,0,17
329,329,2012-2,6,22,22,0,16
329,329,2013-1,6,22,22,0,17
329,329,2013-2,6,20,20,0,15
329,329,2013-3,6,20,20,0,15
330,330,2010-1,6,21,13,8,11
330,330,2010-2,6,21,10,11,10
330,330,2010-C,3,11,7,4,9
330,330,2011-2,6,22,10,12,13
330,330,2011-3,6,22,14,8,12
330,330,2013-1,3,11,7,4,14
330,330,2013-2,4,14,7,7,11
330,330,2013-3,2,7,3,4,14
330,330,2014-1,3,12,8,4,14
330,330,2014-2,6,20,20,0,14
330,330,2015-1,5,20,12,8,14
330,330,2015-2,6,20,16,4,14
331,331,2010-1,6,21,21,0,15
331,331,2010-2,6,22,15,7,14
331,331,2010-C,3,11,11,0,17
331,331,2011-1,6,22,18,4,14
331,331,2011-2,6,22,22,0,15
331,331,2011-3,6,21,11,10,13
331,331,2012-1,6,21,13,8,13
331,331,2012-2,6,22,12,10,11
331,331,2013-2,6,22,22,0,15
331,331,2013-3,6,22,14,8,12
331,331,2014-1,5,18,10,8,13
331,331,2014-2,4,15,4,11,9
331,331,2015-1,6,20,9,11,10
331,331,2015-2,6,21,14,7,13
332,332,2010-2,6,21,17,4,14
332,332,2011-1,6,21,10,11,12
332,332,2011-2,6,21,14,7,11
332,332,2012-1,6,22,4,18,7
332,332,2013-1,6,21,7,14,11
332,332,2013-2,6,22,19,3,13
332,332,2013-3,6,22,14,8,10
332,332,2014-1,5,20,4,16,11
332,332,2014-2,6,21,13,8,12
332,332,2015-1,6,21,21,0,15
332,332,2015-2,6,22,22,0,15
333,333,2010-1,6,21,17,4,14
333,333,2010-2,6,22,11,11,11
333,333,2010-C,2,7,7,0,17
333,333,2011-1,6,22,7,15,13
333,333,2011-2,6,22,6,16,10
333,333,2011-3,6,22,3,19,9
333,333,2012-1,6,22,11,11,11
333,333,2012-2,6,22,18,4,14
333,333,2013-1,6,22,18,4,13
333,333,2013-2,6,22,11,11,12
333,333,2013-3,5,20,12,8,13
333,333,2014-1,6,22,22,0,15
333,333,2014-2,6,22,22,0,15
333,333,2015-1,6,22,18,4,14
333,333,2015-2,6,22,22,0,15
334,334,2010-1,6,21,21,0,17
334,334,2010-2,6,22,22,0,17
334,334,2010-C,3,12,12,0,16
334,334,2011-1,6,22,22,0,18
334,334,2011-2,7,25,25,0,17
334,334,2011-3,6,21,21,0,18
334,334,2012-1,7,25,25,0,16
334,334,2012-2,6,22,22,0,17
334,334,2013-1,6,22,22,0,17
334,334,2013-2,8,24,24,0,15
335,335,2010-1,6,21,21,0,15
335,335,2010-2,6,22,22,0,15
335,335,2010-C,3,11,11,0,18
335,335,2011-1,6,22,4,18,8
335,335,2011-2,6,21,21,0,16
335,335,2011-3,6,22,22,0,17
335,335,2012-1,6,22,22,0,16
335,335,2012-2,6,22,22,0,16
335,335,2013-1,6,22,22,0,16
335,335,2013-2,6,21,21,0,16
335,335,2013-3,7,22,22,0,15
335,335,2014-1,2,6,6,0,16
336,336,2010-1,6,21,21,0,15
336,336,2010-2,6,21,21,0,14
336,336,2010-C,3,11,7,4,14
336,336,2011-3,6,22,14,8,16
336,336,2012-1,6,22,18,4,15
336,336,2012-2,6,22,18,4,13
336,336,2013-1,6,22,22,0,15
336,336,2013-2,5,18,18,0,15
336,336,2013-3,6,22,18,4,14
336,336,2014-1,6,22,22,0,15
336,336,2014-2,6,21,21,0,15
336,336,2015-1,5,16,14,2,14
336,336,2015-2,1,2,2,0,17
337,337,2010-1,6,21,21,0,15
337,337,2010-2,6,21,7,14,11
337,337,2011-1,6,21,18,3,13
337,337,2011-3,6,21,14,7,12
337,337,2012-1,6,22,15,7,12
337,337,2012-2,6,22,15,7,10
337,337,2013-1,6,22,22,0,14
337,337,2013-2,6,22,19,3,14
337,337,2013-3,6,22,19,3,14
337,337,2014-1,6,22,14,8,13
337,337,2014-2,6,22,19,3,13
337,337,2015-1,7,22,18,4,15
338,338,2010-1,6,21,17,4,14
338,338,2010-2,6,21,17,4,14
338,338,2010-C,1,4,4,0,16
338,338,2011-1,6,21,18,3,14
338,338,2011-2,6,22,10,12,13
338,338,2011-3,6,22,18,4,13
338,338,2012-1,6,22,22,0,14
338,338,2012-2,5,20,20,0,14
338,338,2013-1,6,21,14,7,14
338,338,2013-2,3,11,4,7,11
338,338,2013-3,6,21,14,7,13
338,338,2014-1,6,22,12,10,12
338,338,2014-2,6,20,20,0,15
338,338,2015-1,8,26,22,4,14
339,339,2010-1,6,21,21,0,15
339,339,2010-2,6,21,17,4,14
339,339,2010-C,3,12,4,8,11
339,339,2011-1,6,22,14,8,14
339,339,2011-2,6,21,21,0,15
339,339,2011-3,6,22,19,3,14
339,339,2012-1,6,22,18,4,15
339,339,2012-2,6,22,22,0,14
339,339,2013-1,6,22,14,8,14
339,339,2013-2,6,22,18,4,14
339,339,2013-3,6,22,18,4,15
339,339,2014-1,6,21,14,7,13
339,339,2014-2,5,16,16,0,15
340,340,2010-1,6,21,13,8,13
340,340,2010-2,7,22,21,1,15
340,340,2010-C,3,11,0,11,8
340,340,2011-1,6,18,4,14,4
340,340,2011-2,6,18,8,10,9
340,340,2012-1,6,17,12,5,11
340,340,2012-2,7,21,7,14,7
340,340,2013-2,7,21,0,21,5
340,340,2013-3,7,21,3,18,7
340,340,2014-1,7,21,7,14,10
340,340,2014-2,7,17,9,8,9
340,340,2015-1,6,19,7,12,8
340,340,2015-2,8,20,3,17,8
341,341,2010-1,6,21,0,21,0
341,341,2010-2,7,22,0,22,1
341,341,2010-C,2,8,0,8,0
341,341,2011-1,7,22,0,22,3
341,341,2011-2,7,22,3,19,3
341,341,2011-3,6,21,0,21,2
341,341,2012-1,6,21,0,21,0
341,341,2012-2,6,21,0,21,2
341,341,2013-1,6,21,10,11,13
341,341,2013-2,4,13,0,13,0
341,341,2013-3,6,19,15,4,14
341,341,2014-1,6,20,0,20,0
341,341,2014-2,6,20,3,17,9
342,342,2010-1,7,22,17,5,14
343,343,2010-1,6,21,17,4,12
343,343,2010-2,5,17,17,0,16
343,343,2010-C,3,9,9,0,15
343,343,2011-1,6,21,13,8,12
343,343,2011-2,5,19,16,3,14
343,343,2011-3,6,21,13,8,13
343,343,2012-1,6,19,14,5,14
343,343,2012-2,7,22,14,8,12
343,343,2013-1,6,22,18,4,14
343,343,2013-2,6,17,14,3,14
343,343,2013-3,6,21,17,4,14
343,343,2014-1,7,22,18,4,14
343,343,2014-2,6,22,22,0,14
343,343,2015-1,3,14,11,3,14
343,343,2015-2,1,3,3,0,14
344,344,2010-1,6,21,13,8,13
344,344,2010-2,6,22,22,0,14
344,344,2010-C,3,11,11,0,15
344,344,2011-1,7,22,13,9,11
344,344,2011-2,7,21,16,5,14
344,344,2011-3,7,22,10,12,11
344,344,2012-1,5,16,0,16,0
344,344,2012-2,7,20,0,20,2
344,344,2013-1,7,19,8,11,9
344,344,2013-2,6,22,11,11,12
344,344,2013-3,6,22,0,22,4
344,344,2014-1,6,21,3,18,5
344,344,2014-2,6,22,0,22,2
344,344,2015-1,6,21,6,15,7
344,344,2015-2,7,21,0,21,3
345,345,2010-1,6,21,13,8,9
345,345,2010-2,3,9,6,3,10
345,345,2011-1,6,20,0,20,1
346,346,2010-1,6,21,14,7,14
346,346,2010-2,7,22,22,0,15
346,346,2010-C,3,11,7,4,9
346,346,2011-1,6,21,21,0,14
346,346,2011-2,6,22,22,0,15
346,346,2011-3,6,21,13,8,14
346,346,2012-1,6,22,19,3,13
346,346,2012-2,8,21,21,0,14
346,346,2013-1,7,22,19,3,14
346,346,2013-2,7,22,18,4,14
346,346,2013-3,6,22,22,0,15
346,346,2014-1,4,18,6,12,13
346,346,2014-2,2,12,12,0,17
347,347,2010-1,6,22,22,0,16
347,347,2010-2,7,22,21,1,16
347,347,2010-C,3,11,7,4,12
347,347,2011-1,7,21,21,0,15
347,347,2011-2,7,21,21,0,16
347,347,2011-3,7,22,22,0,15
347,347,2012-1,7,22,22,0,15
347,347,2012-2,5,19,19,0,15
347,347,2013-1,6,25,25,0,16
348,348,2010-1,7,22,6,16,10
348,348,2010-2,7,22,7,15,11
348,348,2010-C,3,11,7,4,11
348,348,2011-1,6,19,3,16,9
348,348,2011-2,5,16,3,13,5
348,348,2011-3,5,17,0,17,3
348,348,2012-1,5,17,0,17,0
348,348,2012-2,6,22,0,22,0
348,348,2013-1,6,22,0,22,6
348,348,2013-2,5,16,4,12,6
348,348,2013-3,6,20,6,14,9
348,348,2014-1,6,18,3,15,6
348,348,2014-2,6,18,10,8,10
348,348,2015-1,4,15,0,15,5
348,348,2015-2,5,18,0,18,4
349,349,2010-1,6,21,13,8,13
349,349,2010-2,7,22,18,4,15
349,349,2011-1,5,20,16,4,14
349,349,2011-2,5,19,15,4,13
349,349,2011-3,7,22,17,5,14
349,349,2012-1,7,22,18,4,14
349,349,2012-2,6,21,21,0,15
349,349,2013-1,7,21,21,0,16
349,349,2013-2,7,22,22,0,15
349,349,2013-3,7,22,18,4,15
349,349,2014-1,5,18,18,0,14
349,349,2014-2,4,19,19,0,15
350,350,2010-1,7,22,22,0,18
350,350,2010-2,8,25,25,0,15
350,350,2010-C,3,12,12,0,16
350,350,2011-1,6,22,22,0,15
350,350,2011-2,6,22,18,4,13
350,350,2011-3,6,22,18,4,16
350,350,2012-1,8,22,22,0,16
350,350,2012-2,7,22,12,10,12
350,350,2013-1,7,22,22,0,15
350,350,2013-2,6,22,18,4,15
350,350,2013-3,6,25,25,0,15
351,351,2010-1,7,22,13,9,13
351,351,2010-2,6,19,14,5,14
351,351,2010-C,3,11,7,4,14
351,351,2011-1,6,21,8,13,11
351,351,2011-2,6,21,0,21,5
351,351,2011-3,6,20,8,12,12
351,351,2012-1,7,21,12,9,14
351,351,2012-2,6,21,9,12,11
351,351,2013-1,6,22,14,8,12
351,351,2013-2,6,22,0,22,4
351,351,2013-3,6,22,0,22,7
351,351,2014-1,6,22,3,19,7
351,351,2014-2,4,14,3,11,7
351,351,2015-1,8,21,5,16,4
351,351,2015-2,7,20,11,9,12
352,352,2010-1,6,21,13,8,13
352,352,2010-2,6,22,18,4,13
352,352,2010-C,3,11,11,0,15
352,352,2011-1,7,22,22,0,15
352,352,2011-2,6,22,18,4,14
352,352,2011-3,6,21,17,4,14
352,352,2012-1,7,22,16,6,12
352,352,2012-2,7,21,13,8,12
352,352,2013-1,6,20,9,11,12
352,352,2013-2,7,21,10,11,13
352,352,2013-3,7,22,7,15,12
352,352,2014-1,6,22,7,15,10
352,352,2014-2,6,22,7,15,10
352,352,2015-1,5,19,19,0,14
352,352,2015-2,5,22,4,18,8
353,353,2010-1,5,15,15,0,17
353,353,2010-2,6,21,17,4,13
353,353,2011-1,6,18,17,1,15
353,353,2011-2,7,21,17,4,13
353,353,2011-3,6,21,21,0,16
353,353,2012-1,8,22,18,4,13
353,353,2012-2,6,21,21,0,16
353,353,2013-1,6,20,20,0,15
353,353,2013-2,4,15,15,0,16
353,353,2013-3,3,15,12,3,16
353,353,2014-1,1,3,3,0,15
354,354,2015-1,6,20,8,12,9
354,354,2015-2,7,19,16,3,12
355,355,2010-1,7,22,14,8,12
355,355,2010-2,6,20,12,8,12
355,355,2010-C,3,11,3,8,11
356,356,2010-1,7,22,0,22,7
356,356,2010-2,7,22,12,10,9
356,356,2011-1,7,21,13,8,11
356,356,2011-2,6,18,0,18,9
356,356,2011-3,6,18,0,18,3
356,356,2012-2,4,11,0,11,5
356,356,2013-1,5,16,0,16,5
356,356,2013-2,7,20,9,11,8
356,356,2013-3,4,15,3,12,5
356,356,2014-1,5,19,0,19,3
356,356,2014-2,4,16,0,16,0
356,356,2015-1,4,16,4,12,5
356,356,2015-2,5,20,16,4,12
357,357,2010-1,7,22,13,9,13
357,357,2010-2,6,20,13,7,13
357,357,2010-C,2,6,6,0,14
357,357,2011-1,7,20,9,11,9
357,357,2011-2,7,22,0,22,8
357,357,2011-3,7,22,15,7,14
357,357,2012-1,5,17,13,4,13
357,357,2012-2,5,19,7,12,12
357,357,2013-1,3,12,12,0,16
357,357,2013-3,3,12,8,4,13
357,357,2014-1,3,10,7,3,14
357,357,2014-2,3,11,11,0,15
357,357,2015-1,4,14,14,0,14
357,357,2015-2,3,11,3,8,11
358,358,2010-1,7,22,22,0,15
358,358,2010-2,6,19,13,6,13
358,358,2010-C,3,9,3,6,7
358,358,2011-1,6,20,16,4,14
358,358,2011-2,6,20,10,10,12
358,358,2011-3,6,21,10,11,11
358,358,2012-1,6,22,22,0,14
358,358,2012-2,5,18,14,4,14
358,358,2013-1,6,22,19,3,15
358,358,2013-2,5,18,11,7,13
358,358,2013-3,6,21,17,4,15
358,358,2014-1,6,21,21,0,15
358,358,2014-2,5,19,19,0,15
358,358,2015-1,6,20,20,0,15
359,359,2010-1,7,22,6,16,9
359,359,2010-2,5,16,9,7,10
359,359,2011-1,7,22,22,0,14
359,359,2011-2,6,20,8,12,11
359,359,2011-3,5,17,17,0,14
359,359,2012-1,5,17,14,3,14
359,359,2012-2,3,11,7,4,12
359,359,2013-1,3,12,8,4,10
359,359,2013-3,3,12,4,8,13
359,359,2014-1,3,12,8,4,11
359,359,2014-2,6,22,18,4,15
359,359,2015-1,5,19,19,0,15
359,359,2015-2,6,22,18,4,15
360,360,2010-1,7,22,22,0,16
361,361,2010-1,7,22,22,0,16
361,361,2010-2,7,22,22,0,15
361,361,2011-1,7,22,19,3,14
361,361,2011-2,7,22,16,6,12
361,361,2011-3,6,22,13,9,10
361,361,2012-1,3,10,7,3,13
361,361,2012-2,7,22,18,4,12
361,361,2013-1,6,19,16,3,14
361,361,2013-2,7,22,19,3,14
361,361,2013-3,7,22,22,0,14
361,361,2014-1,7,22,19,3,14
361,361,2014-2,7,22,19,3,14
362,362,2010-1,7,22,19,3,15
362,362,2010-2,7,22,22,0,15
362,362,2010-C,2,6,6,0,19
362,362,2011-1,7,22,13,9,13
362,362,2011-2,7,22,13,9,10
362,362,2011-3,6,22,11,11,8
362,362,2012-1,6,22,7,15,7
362,362,2012-2,6,18,15,3,16
362,362,2013-1,5,17,17,0,15
362,362,2013-2,7,21,15,6,13
362,362,2013-3,7,22,22,0,15
362,362,2014-1,6,19,16,3,14
362,362,2014-2,7,22,12,10,10
362,362,2015-1,5,16,9,7,11
362,362,2015-2,5,18,18,0,15
363,363,2010-1,7,22,2,20,3
363,363,2011-1,6,20,4,16,6
364,364,2010-1,7,22,19,3,12
364,364,2010-2,7,22,0,22,1
364,364,2010-C,3,9,6,3,10
364,364,2011-1,7,22,16,6,12
364,364,2011-2,7,22,0,22,1
365,365,2010-1,7,22,12,10,9
365,365,2010-2,7,22,19,3,12
365,365,2011-1,7,22,3,19,5
365,365,2011-2,7,22,3,19,2
365,365,2011-3,7,22,19,3,13
365,365,2012-1,5,16,16,0,14
365,365,2012-2,5,16,13,3,14
365,365,2013-1,5,20,16,4,13
365,365,2013-2,6,20,20,0,15
365,365,2013-3,7,22,19,3,14
365,365,2014-1,7,22,6,16,9
365,365,2014-2,7,22,12,10,12
365,365,2015-1,7,22,19,3,15
365,365,2015-2,7,22,16,6,14
366,366,2010-1,7,22,22,0,18
366,366,2010-2,7,22,22,0,15
366,366,2010-C,2,6,3,3,7
366,366,2011-1,6,19,9,10,10
366,366,2011-2,7,22,19,3,12
366,366,2011-3,6,22,4,18,5
366,366,2012-1,5,19,13,6,14
366,366,2012-2,7,22,12,10,11
366,366,2013-1,6,18,15,3,12
366,366,2013-2,5,17,4,13,10
366,366,2013-3,6,19,10,9,8
366,366,2014-1,5,16,0,16,1
366,366,2014-2,6,19,3,16,9
366,366,2015-1,6,19,9,10,7
366,366,2015-2,6,19,16,3,12
367,367,2010-1,7,22,2,20,0
368,368,2011-1,7,22,22,0,14
368,368,2011-2,7,22,15,7,13
368,368,2011-3,7,22,10,12,11
368,368,2012-1,7,22,9,13,10
368,368,2012-2,7,22,9,13,12
368,368,2013-1,6,20,17,3,14
368,368,2013-2,5,17,17,0,15
368,368,2013-3,6,21,18,3,14
368,368,2014-1,5,16,9,7,14
368,368,2014-2,7,22,16,6,13
368,368,2015-1,7,22,13,9,14
368,368,2015-2,7,22,19,3,14
369,369,2010-1,7,22,22,0,15
369,369,2010-2,7,22,16,6,13
369,369,2010-C,4,12,9,3,13
369,369,2011-1,7,22,19,3,13
369,369,2011-2,7,22,4,18,7
369,369,2011-3,6,22,4,18,10
369,369,2012-1,6,21,4,17,5
369,369,2012-2,6,21,12,9,11
369,369,2013-1,6,21,15,6,12
369,369,2013-2,6,19,9,10,10
369,369,2013-3,6,21,11,10,10
369,369,2014-1,6,21,0,21,4
369,369,2014-2,6,21,6,15,10
369,369,2015-1,6,19,13,6,12
369,369,2015-2,7,22,13,9,13
370,370,2010-1,7,22,0,22,0
371,371,2010-1,7,22,7,15,5
371,371,2010-2,7,21,18,3,13
371,371,2011-1,7,22,19,3,13
371,371,2011-2,7,22,9,13,11
371,371,2011-3,6,19,15,4,14
371,371,2012-1,6,21,12,9,11
371,371,2012-2,5,16,10,6,11
371,371,2013-1,6,20,11,9,11
371,371,2013-2,6,20,13,7,14
371,371,2013-3,5,16,13,3,14
371,371,2014-1,7,22,13,9,13
371,371,2014-2,7,22,16,6,12
371,371,2015-1,7,21,15,6,12
371,371,2015-2,7,21,21,0,15
372,372,2010-1,7,22,22,0,15
372,372,2010-2,7,22,22,0,15
372,372,2010-C,2,6,6,0,15
372,372,2011-1,7,22,22,0,15
372,372,2011-2,6,19,9,10,9
372,372,2011-3,5,20,11,9,8
372,372,2012-1,6,22,10,12,11
372,372,2012-2,5,16,9,7,11
372,372,2013-1,5,16,6,10,11
372,372,2013-2,5,16,0,16,8
372,372,2013-3,5,16,0,16,7
372,372,2014-1,5,16,7,9,11
372,372,2014-2,6,20,0,20,2
373,373,2010-1,6,21,21,0,14
373,373,2010-2,6,21,14,7,13
373,373,2011-1,6,22,15,7,13
373,373,2011-2,6,21,0,21,4
373,373,2011-3,6,21,0,21,0
373,373,2012-1,6,21,0,21,1
373,373,2012-2,6,21,6,15,10
373,373,2013-1,6,21,3,18,7
373,373,2013-2,6,20,7,13,10
373,373,2013-3,6,21,18,3,13
373,373,2014-1,6,22,15,7,13
373,373,2014-2,6,22,22,0,14
373,373,2015-1,6,21,14,7,12
373,373,2015-2,6,22,7,15,11
374,374,2010-1,6,21,0,21,0
374,374,2010-2,7,22,0,22,0
374,374,2011-1,7,22,0,22,0
374,374,2011-2,7,22,0,22,0
374,374,2013-2,6,19,7,12,8
374,374,2013-3,6,19,3,16,7
374,374,2014-1,5,16,12,4,13
374,374,2014-2,5,19,15,4,13
374,374,2015-1,6,20,9,11,9
374,374,2015-2,5,18,3,15,9
375,375,2010-1,6,21,10,11,13
375,375,2010-2,6,21,21,0,15
375,375,2011-1,6,22,18,4,12
375,375,2011-2,6,22,15,7,12
375,375,2011-3,6,21,7,14,10
375,375,2012-1,6,21,14,7,12
375,375,2012-2,6,22,10,12,12
375,375,2013-1,6,22,4,18,8
375,375,2013-2,6,22,8,14,11
375,375,2013-3,6,22,7,15,8
375,375,2014-1,5,20,16,4,13
375,375,2014-2,6,22,4,18,9
375,375,2015-1,5,18,0,18,1
375,375,2015-2,5,18,15,3,12
376,376,2010-1,6,21,18,3,12
376,376,2010-2,6,21,9,12,12
376,376,2010-C,1,3,3,0,15
376,376,2011-1,6,21,10,11,9
376,376,2011-2,5,18,11,7,9
376,376,2011-3,6,21,0,21,0
376,376,2012-1,4,15,7,8,12
376,376,2012-2,6,22,14,8,13
376,376,2013-1,5,18,14,4,13
376,376,2013-2,5,17,10,7,12
376,376,2013-3,4,14,10,4,13
376,376,2014-1,5,19,15,4,14
376,376,2014-2,4,15,7,8,12
377,377,2010-1,6,21,10,11,11
377,377,2010-2,6,21,6,15,7
378,378,2010-1,7,22,22,0,15
378,378,2010-2,7,22,19,3,15
378,378,2011-1,7,22,17,5,14
378,378,2011-2,6,20,20,0,16
378,378,2011-3,6,21,18,3,14
378,378,2012-1,6,20,17,3,15
378,378,2012-2,6,22,18,4,14
378,378,2013-1,5,19,19,0,16
378,378,2013-2,6,22,22,0,16
378,378,2013-3,5,19,12,7,14
378,378,2014-1,5,17,17,0,16
378,378,2014-2,6,20,20,0,17
379,379,2010-1,6,21,17,4,14
379,379,2010-2,6,21,21,0,14
379,379,2010-C,3,11,3,8,12
379,379,2011-1,6,22,14,8,13
379,379,2013-1,6,21,14,7,13
380,380,2010-1,6,21,21,0,16
380,380,2010-2,6,22,22,0,16
380,380,2010-C,3,11,11,0,17
380,380,2011-1,6,22,22,0,17
380,380,2011-2,6,22,22,0,16
380,380,2011-3,6,22,22,0,15
380,380,2012-1,6,22,22,0,17
380,380,2012-2,6,22,22,0,15
380,380,2013-1,6,22,22,0,16
380,380,2013-2,7,21,21,0,16
380,380,2013-3,3,9,9,0,16
381,381,2010-1,6,21,18,3,15
381,381,2010-2,6,21,21,0,15
381,381,2010-C,1,3,3,0,16
381,381,2011-1,6,22,18,4,14
381,381,2011-2,6,22,14,8,12
381,381,2011-3,7,22,22,0,15
381,381,2012-1,6,22,22,0,15
381,381,2012-2,5,20,16,4,15
381,381,2013-1,6,22,22,0,15
381,381,2013-2,6,22,22,0,14
381,381,2013-3,6,22,22,0,15
381,381,2014-1,5,16,16,0,15
382,382,2010-1,6,21,17,4,14
382,382,2010-2,6,21,17,4,13
382,382,2010-C,3,11,11,0,14
382,382,2011-1,6,22,18,4,15
382,382,2011-2,6,21,18,3,14
382,382,2012-2,6,22,18,4,14
382,382,2013-1,6,21,18,3,14
382,382,2013-2,6,21,17,4,13
382,382,2013-3,4,15,12,3,14
382,382,2014-1,5,18,18,0,15
382,382,2014-2,6,22,22,0,16
382,382,2015-1,6,20,17,3,15
382,382,2015-2,4,13,13,0,15
383,383,2010-1,6,21,17,4,15
383,383,2010-2,6,21,21,0,16
383,383,2011-1,7,21,17,4,14
383,383,2011-2,6,22,18,4,15
383,383,2011-3,6,22,18,4,13
383,383,2012-1,6,22,19,3,14
383,383,2012-2,8,22,18,4,14
383,383,2013-1,7,22,10,12,10
383,383,2013-2,7,22,10,12,10
383,383,2013-3,7,22,4,18,6
383,383,2014-1,6,21,18,3,14
383,383,2014-2,6,22,4,18,8
383,383,2015-2,6,21,7,14,10
384,384,2010-1,7,22,22,0,15
384,384,2010-2,7,22,22,0,15
384,384,2010-C,2,6,6,0,15
384,384,2011-1,7,22,22,0,14
384,384,2011-2,5,16,16,0,14
384,384,2011-3,5,20,20,0,16
384,384,2012-1,7,22,15,7,14
384,384,2012-2,7,22,22,0,17
384,384,2013-1,7,22,22,0,15
384,384,2013-2,7,22,22,0,16
384,384,2013-3,8,26,26,0,15
385,385,2010-1,7,22,0,22,0
386,386,2010-1,6,21,7,14,7
386,386,2011-1,5,18,0,18,1
387,387,2010-1,6,21,0,21,2
388,388,2010-1,7,22,22,0,15
388,388,2010-2,7,22,22,0,15
388,388,2011-1,7,22,19,3,14
388,388,2011-2,7,22,13,9,11
388,388,2012-1,6,21,15,6,14
388,388,2012-2,6,20,20,0,14
388,388,2013-1,7,22,16,6,13
388,388,2013-2,6,19,16,3,13
388,388,2013-3,6,20,17,3,14
388,388,2014-1,7,22,22,0,14
388,388,2014-2,7,21,21,0,15
388,388,2015-1,4,12,12,0,15
389,389,2010-1,6,21,10,11,9
389,389,2010-2,6,21,10,11,13
389,389,2010-C,2,7,3,4,13
389,389,2011-1,6,22,8,14,10
389,389,2011-2,6,22,10,12,10
389,389,2011-3,6,22,18,4,13
389,389,2012-1,5,20,8,12,7
389,389,2012-2,5,20,16,4,14
389,389,2013-1,6,22,11,11,11
389,389,2013-2,3,12,4,8,7
389,389,2013-3,6,22,18,4,13
389,389,2014-1,6,22,15,7,12
389,389,2014-2,6,22,15,7,12
389,389,2015-1,6,22,14,8,13
389,389,2015-2,6,22,22,0,14
390,390,2010-1,6,21,21,0,17
390,390,2010-2,6,22,22,0,17
390,390,2010-C,3,11,11,0,18
390,390,2011-1,6,22,22,0,16
390,390,2011-2,6,22,22,0,16
390,390,2011-3,6,22,22,0,15
390,390,2012-1,6,22,22,0,15
390,390,2012-2,6,22,22,0,15
390,390,2013-1,6,22,22,0,15
390,390,2013-2,7,21,21,0,16
390,390,2013-3,3,9,9,0,17
391,391,2010-1,6,21,10,11,13
391,391,2010-2,6,21,18,3,14
391,391,2010-C,2,7,7,0,16
391,391,2011-1,6,22,10,12,8
391,391,2011-2,6,22,18,4,12
391,391,2011-3,6,22,6,16,6
391,391,2012-1,6,22,11,11,9
391,391,2012-2,6,21,10,11,11
391,391,2013-1,5,19,11,8,10
391,391,2013-2,6,21,21,0,14
391,391,2013-3,6,22,11,11,10
391,391,2014-1,5,20,12,8,13
391,391,2014-2,6,22,22,0,16
391,391,2015-1,6,22,22,0,15
391,391,2015-2,6,22,22,0,15
392,392,2010-1,7,22,18,4,15
392,392,2010-2,7,22,9,13,9
392,392,2011-1,6,19,0,19,0
393,393,2010-1,6,21,0,21,0
394,394,2010-1,6,21,21,0,15
394,394,2010-2,6,21,15,6,12
394,394,2010-C,3,11,4,7,9
394,394,2011-1,6,22,11,11,11
394,394,2011-2,6,21,18,3,14
394,394,2011-3,6,22,12,10,10
394,394,2012-1,6,22,3,19,4
394,394,2012-2,6,21,14,7,13
394,394,2013-1,6,21,14,7,11
394,394,2013-2,6,22,6,16,9
394,394,2013-3,6,22,18,4,13
394,394,2014-1,6,22,22,0,14
394,394,2014-2,6,22,7,15,12
394,394,2015-1,5,20,16,4,14
394,394,2015-2,3,12,0,12,3
395,395,2010-1,6,21,17,4,14
395,395,2010-2,6,22,22,0,16
395,395,2010-C,3,11,11,0,18
395,395,2011-1,6,22,18,4,15
395,395,2011-2,6,22,22,0,17
395,395,2011-3,6,22,22,0,17
395,395,2012-1,6,22,22,0,16
395,395,2012-2,6,21,21,0,16
395,395,2013-1,6,22,22,0,16
395,395,2013-2,6,21,21,0,17
395,395,2013-3,6,18,18,0,17
396,396,2010-1,6,21,21,0,15
396,396,2010-2,6,21,21,0,15
396,396,2010-C,3,11,11,0,17
396,396,2011-1,6,22,22,0,15
396,396,2011-2,6,22,10,12,14
396,396,2011-3,6,22,14,8,13
396,396,2012-1,6,22,22,0,16
396,396,2012-2,6,22,18,4,13
396,396,2013-1,6,22,15,7,13
396,396,2013-2,6,22,15,7,11
396,396,2013-3,6,22,14,8,14
396,396,2014-1,7,22,9,13,8
396,396,2014-2,7,24,0,24,6
397,397,2010-1,4,15,4,11,10
397,397,2010-2,6,21,21,0,15
397,397,2011-1,6,22,15,7,13
397,397,2011-2,6,22,10,12,12
397,397,2012-2,5,18,11,7,13
397,397,2013-1,6,22,8,14,9
397,397,2013-2,6,22,14,8,13
397,397,2013-3,6,22,0,22,3
397,397,2014-1,3,12,12,0,14
397,397,2014-2,6,22,18,4,11
397,397,2015-1,4,14,10,4,13
397,397,2015-2,5,17,17,0,14
398,398,2010-1,7,22,18,4,13
398,398,2010-2,7,22,19,3,14
398,398,2011-1,6,19,19,0,15
398,398,2011-2,6,20,7,13,10
398,398,2011-3,5,16,4,12,7
398,398,2013-1,1,3,3,0,15
398,398,2013-2,2,7,0,7,2
399,399,2010-1,6,21,21,0,16
399,399,2010-2,6,22,22,0,16
399,399,2010-C,2,7,7,0,17
399,399,2011-1,6,22,22,0,16
399,399,2011-2,6,22,22,0,16
399,399,2011-3,6,21,21,0,15
399,399,2012-1,6,22,22,0,16
399,399,2012-2,6,21,18,3,15
399,399,2013-1,6,21,21,0,15
399,399,2013-2,6,22,18,4,14
399,399,2013-3,7,22,22,0,15
400,400,2010-1,6,21,13,8,9
400,400,2010-2,6,21,21,0,14
400,400,2010-C,3,11,7,4,13
400,400,2011-2,6,21,14,7,11
400,400,2011-3,6,22,15,7,12
400,400,2012-1,6,22,18,4,14
400,400,2012-2,6,22,18,4,14
400,400,2013-1,5,19,15,4,14
400,400,2013-2,6,22,22,0,15
400,400,2013-3,6,22,22,0,14
400,400,2014-1,5,19,19,0,15
400,400,2014-2,6,21,17,4,13
400,400,2015-1,6,18,15,3,12
401,401,2010-1,6,21,13,8,13
401,401,2010-2,7,22,18,4,14
401,401,2010-C,3,12,8,4,13
401,401,2011-1,6,21,20,1,14
401,401,2011-2,6,22,18,4,13
401,401,2011-3,7,21,8,13,13
401,401,2012-1,7,22,10,12,12
401,401,2012-2,6,22,11,11,13
401,401,2014-1,7,22,18,4,14
401,401,2014-2,7,22,14,8,12
401,401,2015-1,6,21,10,11,11
401,401,2015-2,7,22,11,11,13
402,402,2010-1,6,21,21,0,15
402,402,2010-2,6,21,21,0,15
402,402,2011-1,6,22,22,0,15
402,402,2011-2,6,22,22,0,15
402,402,2011-3,6,22,22,0,15
402,402,2012-1,6,21,21,0,15
402,402,2012-2,6,22,22,0,16
402,402,2013-1,6,22,22,0,16
402,402,2013-2,6,22,22,0,15
402,402,2013-3,7,21,21,0,15
403,403,2010-1,6,21,0,21,2
404,404,2010-1,7,22,0,22,0
405,405,2010-1,6,21,17,4,14
405,405,2010-2,6,21,10,11,11
405,405,2011-1,6,21,17,4,14
405,405,2011-2,6,22,22,0,14
405,405,2011-3,6,22,11,11,13
405,405,2012-1,6,22,20,2,15
405,405,2012-2,6,22,22,0,15
405,405,2013-1,6,22,18,4,15
405,405,2013-2,6,22,19,3,15
405,405,2013-3,6,22,18,4,14
405,405,2014-1,6,21,21,0,15
405,405,2014-2,7,21,21,0,14
406,406,2010-1,6,21,17,4,12
406,406,2010-2,6,21,17,4,13
406,406,2011-1,6,22,6,16,10
406,406,2011-2,6,22,0,22,0
406,406,2012-2,5,19,16,3,14
406,406,2013-1,5,18,14,4,15
406,406,2013-2,6,21,11,10,11
406,406,2013-3,6,19,19,0,14
406,406,2014-1,4,15,7,8,7
406,406,2015-1,5,20,20,0,14
406,406,2015-2,6,22,10,12,11
407,407,2010-1,6,21,10,11,13
407,407,2010-2,6,21,18,3,14
407,407,2010-C,2,7,7,0,15
407,407,2011-1,6,22,18,4,14
407,407,2011-2,6,22,22,0,15
407,407,2011-3,6,22,22,0,15
407,407,2012-1,6,21,21,0,15
407,407,2012-2,6,22,22,0,16
407,407,2013-1,6,20,20,0,16
407,407,2013-2,5,20,16,4,15
407,407,2013-3,6,22,22,0,16
407,407,2014-1,7,21,21,0,15
408,408,2010-1,6,21,17,4,14
408,408,2010-2,6,21,10,11,10
408,408,2010-C,3,11,7,4,9
408,408,2011-1,6,22,7,15,9
408,408,2011-2,7,22,12,10,9
408,408,2011-3,6,21,3,18,6
408,408,2012-1,5,18,4,14,8
408,408,2012-2,3,11,8,3,14
408,408,2013-1,5,20,12,8,9
408,408,2013-2,6,22,11,11,10
408,408,2013-3,6,22,6,16,7
408,408,2014-1,6,22,11,11,11
408,408,2014-2,5,20,8,12,10
409,409,2010-1,6,21,21,0,15
409,409,2010-2,6,21,21,0,16
409,409,2011-1,6,22,22,0,17
409,409,2011-2,6,22,22,0,16
409,409,2011-3,6,22,22,0,15
409,409,2012-1,6,21,21,0,15
409,409,2012-2,6,22,22,0,15
409,409,2013-1,6,22,22,0,17
409,409,2013-2,6,22,22,0,16
409,409,2013-3,7,21,21,0,15
410,410,2010-1,6,21,4,17,8
410,410,2010-2,6,21,8,13,7
410,410,2011-1,6,21,0,21,5
410,410,2011-2,6,21,0,21,3
410,410,2012-2,5,18,11,7,11
410,410,2013-1,6,22,0,22,5
410,410,2013-2,6,22,8,14,7
410,410,2014-1,6,20,4,16,4
411,411,2010-1,6,21,21,0,14
411,411,2010-2,6,21,14,7,11
411,411,2011-1,6,22,18,4,14
412,412,2010-1,4,11,0,11,4
412,412,2010-2,4,11,7,4,10
412,412,2011-1,7,22,14,8,12
412,412,2011-2,7,22,18,4,12
412,412,2011-3,7,22,18,4,14
412,412,2012-1,7,21,3,18,9
412,412,2012-2,7,21,0,21,4
412,412,2013-1,7,19,7,12,10
412,412,2013-2,7,21,0,21,9
412,412,2013-3,7,22,1,21,8
412,412,2014-1,6,22,7,15,9
412,412,2014-2,6,21,0,21,3
412,412,2015-1,7,20,6,14,10
412,412,2015-2,6,20,3,17,9
413,413,2010-1,6,21,17,4,13
413,413,2010-2,6,21,17,4,14
413,413,2011-3,6,21,21,0,14
413,413,2012-1,6,20,11,9,13
413,413,2012-2,6,20,20,0,15
413,413,2013-1,6,20,9,11,12
413,413,2013-2,6,22,10,12,12
413,413,2014-1,6,22,6,16,12
413,413,2014-2,5,18,3,15,10
413,413,2015-1,6,21,10,11,13
414,414,2010-1,6,21,21,0,16
414,414,2010-2,6,21,21,0,15
414,414,2011-1,7,22,22,0,15
414,414,2011-2,6,22,22,0,15
414,414,2011-3,7,22,18,4,14
414,414,2012-1,7,22,18,4,15
414,414,2012-2,6,21,17,4,14
414,414,2013-1,7,21,21,0,15
414,414,2013-2,6,22,22,0,14
414,414,2013-3,5,21,21,0,14
415,415,2010-1,7,22,22,0,16
415,415,2010-2,6,20,20,0,16
415,415,2010-C,3,11,11,0,17
415,415,2011-1,6,22,22,0,16
415,415,2011-2,6,22,22,0,16
415,415,2011-3,7,22,22,0,17
415,415,2012-1,7,20,20,0,15
415,415,2012-2,7,22,22,0,16
415,415,2013-1,7,22,22,0,17
415,415,2013-2,6,21,21,0,16
415,415,2013-3,2,12,12,0,15
416,416,2010-1,6,21,21,0,15
416,416,2010-2,6,22,22,0,16
416,416,2010-C,3,11,11,0,14
416,416,2011-1,7,21,17,4,15
416,416,2011-2,6,22,22,0,15
416,416,2011-3,7,22,22,0,16
416,416,2012-1,7,22,22,0,15
416,416,2012-2,8,22,22,0,15
416,416,2013-1,6,21,17,4,12
416,416,2013-2,6,22,22,0,16
416,416,2013-3,4,18,18,0,15
417,417,2010-1,6,21,4,17,11
417,417,2010-2,6,21,10,11,8
417,417,2011-1,6,21,17,4,14
417,417,2011-2,6,22,14,8,9
417,417,2011-3,5,18,11,7,12
417,417,2012-1,6,21,7,14,5
417,417,2013-1,6,19,6,13,8
417,417,2013-2,4,14,0,14,1
417,417,2013-3,4,14,4,10,8
417,417,2014-1,5,19,0,19,3
417,417,2014-2,6,18,0,18,0
417,417,2015-2,5,15,0,15,5
418,418,2010-1,6,21,21,0,14
418,418,2010-2,6,21,21,0,15
418,418,2011-1,6,22,22,0,15
418,418,2011-2,6,22,19,3,14
418,418,2011-3,6,22,22,0,15
418,418,2012-1,6,21,21,0,16
418,418,2012-2,6,22,18,4,15
418,418,2013-1,6,21,21,0,16
418,418,2013-2,6,22,18,4,14
418,418,2013-3,6,20,16,4,13
418,418,2014-1,4,14,11,3,14
418,418,2014-2,3,9,6,3,14
418,418,2015-1,1,3,3,0,15
419,419,2010-1,6,21,14,7,14
419,419,2010-2,6,21,17,4,14
419,419,2010-C,2,7,7,0,16
419,419,2011-1,6,22,18,4,15
419,419,2011-2,6,21,18,3,14
419,419,2011-3,6,22,14,8,13
419,419,2012-1,5,18,14,4,14
419,419,2012-2,6,22,18,4,14
419,419,2013-1,6,22,22,0,15
419,419,2013-2,6,22,22,0,15
419,419,2013-3,6,21,21,0,15
419,419,2014-1,6,21,21,0,15
419,419,2014-2,4,13,13,0,15
420,420,2010-1,6,21,21,0,16
420,420,2010-2,6,21,21,0,16
420,420,2011-1,6,22,22,0,16
420,420,2011-2,6,22,22,0,16
420,420,2011-3,6,22,22,0,16
420,420,2012-1,6,21,21,0,16
420,420,2012-2,6,22,22,0,16
420,420,2013-1,6,22,22,0,17
420,420,2013-2,6,22,22,0,16
420,420,2013-3,7,21,21,0,16
421,421,2010-1,6,21,0,21,0
422,422,2010-1,6,21,21,0,16
422,422,2010-2,6,21,21,0,16
422,422,2011-1,6,22,22,0,16
422,422,2011-2,6,22,22,0,14
422,422,2011-3,6,22,22,0,15
422,422,2012-1,6,21,21,0,15
422,422,2012-2,6,22,22,0,16
422,422,2013-1,6,22,22,0,16
422,422,2013-2,6,22,22,0,15
422,422,2013-3,7,21,21,0,14
423,423,2010-1,6,21,21,0,16
423,423,2010-2,6,21,21,0,15
423,423,2011-1,6,22,22,0,16
423,423,2011-2,6,22,22,0,15
423,423,2011-3,6,22,22,0,15
423,423,2012-1,6,21,21,0,15
423,423,2012-2,6,22,22,0,16
423,423,2013-1,6,22,22,0,16
423,423,2013-2,6,22,18,4,15
423,423,2013-3,5,16,12,4,14
423,423,2014-1,4,13,9,4,14
423,423,2014-2,1,4,4,0,14
424,424,2010-1,6,21,0,21,0
424,424,2010-2,6,21,0,21,2
424,424,2011-1,6,21,0,21,0
424,424,2011-2,6,21,0,21,0
424,424,2011-3,6,21,0,21,0
424,424,2012-1,6,21,0,21,0
425,425,2010-1,6,21,10,11,12
425,425,2010-2,6,21,13,8,14
425,425,2010-C,2,7,7,0,14
425,425,2015-2,5,15,15,0,14
426,426,2010-1,6,21,21,0,16
426,426,2010-2,6,21,21,0,17
426,426,2011-1,6,22,22,0,16
426,426,2011-2,6,22,22,0,16
426,426,2011-3,6,22,22,0,15
426,426,2012-1,6,22,18,4,15
426,426,2012-2,6,22,22,0,16
426,426,2013-1,6,22,22,0,16
426,426,2013-2,6,22,22,0,16
426,426,2013-3,8,24,24,0,16
427,427,2010-1,6,21,17,4,14
427,427,2010-2,6,21,17,4,13
427,427,2011-1,6,21,14,7,13
427,427,2011-2,6,21,18,3,14
427,427,2011-3,6,22,18,4,13
427,427,2012-1,4,16,12,4,11
427,427,2012-2,6,21,10,11,10
427,427,2013-1,6,22,8,14,8
427,427,2013-2,6,22,0,22,3
427,427,2013-3,3,12,0,12,1
427,427,2014-1,6,22,14,8,12
427,427,2014-2,6,22,22,0,15
427,427,2015-1,6,22,12,10,12
427,427,2015-2,6,22,0,22,6
428,428,2010-1,6,21,21,0,16
428,428,2010-2,6,21,21,0,16
428,428,2011-1,6,22,22,0,15
428,428,2011-2,6,22,22,0,15
428,428,2011-3,6,22,22,0,15
428,428,2012-1,6,21,21,0,15
428,428,2012-2,6,22,22,0,16
428,428,2013-1,6,22,22,0,17
428,428,2013-2,6,22,22,0,16
428,428,2013-3,7,21,21,0,16
429,429,2010-1,6,21,21,0,15
429,429,2010-2,6,21,21,0,16
429,429,2011-1,6,22,22,0,16
429,429,2011-2,6,22,22,0,16
429,429,2011-3,6,22,22,0,16
429,429,2012-1,6,21,21,0,16
429,429,2012-2,6,22,22,0,17
429,429,2013-1,6,22,22,0,18
429,429,2013-2,7,25,25,0,16
429,429,2013-3,7,21,21,0,16
430,430,2010-1,6,21,21,0,17
430,430,2010-2,6,21,21,0,16
430,430,2011-1,6,22,22,0,17
430,430,2011-2,6,22,22,0,17
430,430,2011-3,6,22,22,0,17
430,430,2012-1,6,21,21,0,16
430,430,2012-2,6,22,22,0,17
430,430,2013-1,6,22,22,0,17
430,430,2013-2,7,25,25,0,16
430,430,2013-3,7,21,21,0,16
431,431,2010-1,6,21,10,11,13
431,431,2010-2,6,21,13,8,12
431,431,2010-C,2,7,7,0,15
431,431,2011-1,6,21,10,11,12
431,431,2011-2,5,17,14,3,12
431,431,2011-3,5,17,13,4,13
431,431,2012-1,4,16,8,8,10
431,431,2012-2,4,16,16,0,15
431,431,2013-1,6,22,22,0,15
431,431,2013-2,6,22,22,0,14
431,431,2013-3,6,22,22,0,14
431,431,2014-1,6,22,22,0,15
431,431,2014-2,6,22,22,0,15
431,431,2015-1,5,15,12,3,14
431,431,2015-2,1,3,3,0,15
432,432,2010-1,6,21,18,3,12
432,432,2010-2,6,21,18,3,13
432,432,2010-C,1,3,0,3,0
432,432,2011-1,6,22,11,11,9
432,432,2011-2,6,22,4,18,3
432,432,2012-2,6,21,10,11,11
432,432,2013-1,6,22,22,0,15
432,432,2013-2,6,20,17,3,14
432,432,2013-3,6,22,6,16,9
432,432,2014-1,6,22,22,0,14
432,432,2014-2,5,18,10,8,10
432,432,2015-1,5,19,15,4,11
432,432,2015-2,4,15,4,11,5
433,433,2010-1,6,21,18,3,14
433,433,2010-2,6,21,17,4,12
433,433,2011-1,6,22,8,14,8
433,433,2011-2,6,22,8,14,7
433,433,2011-3,3,11,4,7,5
433,433,2012-1,5,18,7,11,6
433,433,2012-2,6,22,15,7,12
433,433,2013-1,7,22,9,13,8
433,433,2013-2,4,14,7,7,7
433,433,2013-3,4,15,15,0,14
433,433,2014-1,6,22,22,0,15
433,433,2014-2,6,22,22,0,15
433,433,2015-1,6,21,21,0,15
433,433,2015-2,6,21,19,2,15
434,434,2010-1,6,21,14,7,14
434,434,2010-2,6,21,21,0,14
434,434,2010-C,2,7,7,0,16
434,434,2011-1,6,22,14,8,14
434,434,2011-2,6,22,15,7,14
434,434,2011-3,6,22,14,8,13
434,434,2012-1,5,18,10,8,13
434,434,2012-2,6,22,18,4,14
434,434,2013-1,6,21,21,0,15
434,434,2013-2,6,22,22,0,15
434,434,2013-3,5,19,19,0,15
434,434,2014-1,6,22,22,0,15
434,434,2014-2,7,22,19,3,15
434,434,2015-1,1,3,3,0,14
435,435,2010-1,6,21,0,21,6
436,436,2010-1,6,21,17,4,15
436,436,2010-2,6,21,17,4,14
436,436,2010-C,1,4,4,0,16
436,436,2011-1,6,22,3,19,4
436,436,2013-2,6,22,22,0,16
436,436,2013-3,6,22,22,0,16
436,436,2014-1,5,20,20,0,16
436,436,2014-2,6,22,22,0,16
436,436,2015-1,6,22,22,0,16
436,436,2015-2,6,22,22,0,16
437,437,2010-1,6,21,10,11,13
437,437,2010-2,5,18,11,7,11
437,437,2011-1,6,21,10,11,11
437,437,2011-2,6,22,18,4,14
437,437,2011-3,6,22,15,7,14
437,437,2012-1,5,18,14,4,14
437,437,2012-2,6,21,13,8,14
437,437,2013-1,5,19,15,4,14
437,437,2013-2,6,22,14,8,12
437,437,2013-3,6,22,11,11,11
437,437,2014-1,6,22,10,12,12
437,437,2014-2,6,22,11,11,12
437,437,2015-1,6,22,18,4,13
437,437,2015-2,4,15,15,0,15
438,438,2010-1,6,21,14,7,13
438,438,2010-2,6,21,21,0,14
438,438,2011-1,6,22,11,11,13
438,438,2011-2,6,22,18,4,14
438,438,2011-3,3,12,8,4,12
438,438,2012-1,6,22,3,19,10
438,438,2012-2,6,22,3,19,9
438,438,2013-1,6,22,7,15,10
438,438,2013-3,5,19,7,12,9
438,438,2014-1,6,22,14,8,13
438,438,2014-2,6,21,13,8,12
438,438,2015-1,5,18,11,7,13
438,438,2015-2,6,22,11,11,12
439,439,2010-1,6,21,0,21,3
440,440,2010-1,6,21,21,0,16
440,440,2010-2,6,21,21,0,16
440,440,2011-1,6,22,22,0,15
440,440,2011-2,6,22,22,0,15
440,440,2011-3,6,22,22,0,15
440,440,2012-1,6,22,22,0,15
440,440,2012-2,6,22,22,0,16
440,440,2013-1,6,22,22,0,16
440,440,2013-2,6,21,21,0,15
440,440,2013-3,7,21,21,0,15
441,441,2010-1,6,21,21,0,16
441,441,2010-2,6,21,17,4,14
441,441,2011-1,6,22,14,8,10
441,441,2011-2,6,22,0,22,0
441,441,2011-3,6,22,11,11,9
441,441,2012-1,5,18,10,8,11
441,441,2012-2,6,20,12,8,12
441,441,2013-1,3,11,11,0,15
441,441,2013-2,6,22,18,4,14
441,441,2013-3,6,22,22,0,14
441,441,2014-1,5,20,20,0,14
441,441,2014-2,5,20,20,0,15
441,441,2015-1,6,22,19,3,15
441,441,2015-2,7,21,21,0,16
442,442,2010-1,6,21,21,0,15
442,442,2010-2,6,21,21,0,16
442,442,2011-1,6,22,22,0,15
442,442,2011-2,6,22,22,0,15
442,442,2011-3,6,22,22,0,15
442,442,2012-1,6,21,21,0,15
442,442,2012-2,6,22,22,0,16
442,442,2013-1,6,22,22,0,16
442,442,2013-2,6,22,22,0,15
442,442,2013-3,7,21,21,0,15
443,443,2010-1,6,21,0,21,0
444,444,2010-1,6,21,14,7,12
445,445,2010-1,6,21,21,0,15
445,445,2010-2,6,21,17,4,14
445,445,2011-1,6,22,22,0,15
445,445,2011-2,6,21,14,7,14
445,445,2012-2,5,19,11,8,13
445,445,2013-1,6,22,18,4,14
445,445,2013-2,6,22,18,4,12
445,445,2013-3,6,22,14,8,12
445,445,2014-1,5,19,19,0,15
445,445,2014-2,5,20,20,0,15
445,445,2015-1,6,20,20,0,15
445,445,2015-2,7,22,22,0,15
446,446,2010-1,6,21,21,0,16
446,446,2010-2,6,21,21,0,16
446,446,2011-1,6,22,22,0,15
446,446,2011-2,6,22,22,0,15
446,446,2011-3,6,22,22,0,15
446,446,2012-1,6,21,21,0,16
446,446,2012-2,6,22,22,0,16
446,446,2013-1,6,22,22,0,15
446,446,2013-2,6,22,18,4,15
446,446,2013-3,8,25,25,0,15
447,447,2010-1,6,21,17,4,14
447,447,2010-2,6,21,17,4,13
447,447,2011-1,6,22,22,0,15
447,447,2011-2,6,21,17,4,12
447,447,2011-3,5,18,14,4,12
447,447,2012-1,6,21,17,4,13
447,447,2012-2,6,22,18,4,13
447,447,2013-1,5,17,17,0,16
447,447,2013-2,5,19,15,4,14
447,447,2013-3,5,18,18,0,16
447,447,2014-1,4,15,15,0,15
447,447,2014-2,5,17,17,0,15
447,447,2015-1,1,4,4,0,18
447,447,2015-2,3,11,11,0,16
448,448,2010-1,6,21,21,0,15
448,448,2010-2,6,21,17,4,14
448,448,2011-1,6,22,18,4,15
448,448,2011-2,6,21,21,0,14
448,448,2011-3,6,22,22,0,15
448,448,2012-1,6,22,14,8,12
448,448,2012-2,6,22,10,12,12
448,448,2013-1,6,21,7,14,10
448,448,2013-2,6,22,14,8,12
448,448,2013-3,5,20,12,8,12
448,448,2014-1,6,22,22,0,15
448,448,2014-2,4,14,14,0,14
448,448,2015-1,7,24,17,7,14
448,448,2015-2,2,7,7,0,15
449,449,2010-1,6,21,14,7,13
449,449,2010-2,6,21,18,3,14
449,449,2011-1,6,22,15,7,13
449,449,2011-2,6,21,15,6,10
449,449,2011-3,6,22,4,18,7
449,449,2012-1,5,17,4,13,3
449,449,2012-2,6,21,7,14,8
449,449,2013-1,5,16,6,10,11
449,449,2013-2,6,22,11,11,8
449,449,2013-3,6,21,3,18,6
449,449,2014-1,6,22,11,11,13
449,449,2014-2,6,22,3,19,8
449,449,2015-1,6,22,0,22,2
449,449,2015-2,7,20,0,20,4
450,450,2010-1,6,21,21,0,15
450,450,2010-2,6,21,17,4,14
450,450,2011-1,6,21,15,6,13
450,450,2011-2,6,22,22,0,14
450,450,2011-3,6,22,22,0,15
450,450,2012-1,6,21,21,0,15
450,450,2012-2,6,22,22,0,16
450,450,2013-1,6,22,22,0,16
450,450,2013-2,6,22,22,0,15
450,450,2013-3,7,22,22,0,15
450,450,2014-1,3,10,10,0,14
451,451,2010-1,6,21,0,21,6
452,452,2010-1,6,21,21,0,14
452,452,2010-2,6,21,14,7,13
452,452,2011-1,6,22,15,7,12
452,452,2011-2,6,21,18,3,12
452,452,2011-3,6,22,18,4,13
452,452,2012-1,6,22,14,8,12
452,452,2012-2,5,20,20,0,15
452,452,2013-1,6,22,14,8,13
452,452,2013-2,6,22,18,4,14
452,452,2013-3,6,22,22,0,15
452,452,2014-1,7,22,0,22,0
453,453,2010-1,6,21,13,8,13
453,453,2014-1,5,14,10,4,14
453,453,2014-2,4,14,14,0,15
453,453,2015-1,4,14,14,0,15
453,453,2015-2,4,16,16,0,14
454,454,2010-1,6,21,15,6,12
454,454,2010-2,6,21,14,7,11
454,454,2010-C,1,3,3,0,15
454,454,2011-1,6,22,8,14,5
454,454,2011-2,6,22,0,22,0
454,454,2011-3,7,24,11,13,7
454,454,2012-1,6,21,13,8,9
454,454,2012-2,6,19,6,13,6
454,454,2013-1,6,20,10,10,12
454,454,2013-2,4,14,7,7,10
454,454,2013-3,5,17,10,7,9
454,454,2014-1,5,18,15,3,13
454,454,2014-2,6,20,3,17,10
454,454,2015-1,6,20,0,20,4
454,454,2015-2,6,22,7,15,8
455,455,2010-1,6,21,14,7,12
455,455,2010-2,6,21,14,7,11
455,455,2010-C,2,7,4,3,8
455,455,2011-1,6,22,0,22,0
455,455,2012-1,6,22,14,8,13
455,455,2012-2,6,20,20,0,14
455,455,2013-2,6,22,18,4,12
455,455,2013-3,5,19,7,12,11
455,455,2014-1,6,22,22,0,16
455,455,2014-2,6,22,15,7,12
455,455,2015-2,6,21,11,10,13
456,456,2010-1,6,21,21,0,16
456,456,2010-2,6,21,21,0,16
456,456,2011-1,6,22,14,8,14
456,456,2011-2,6,22,22,0,15
456,456,2011-3,6,22,22,0,15
456,456,2012-1,6,21,21,0,16
456,456,2012-2,6,22,22,0,17
456,456,2013-1,4,14,14,0,18
456,456,2013-2,6,24,24,0,16
456,456,2013-3,6,21,21,0,16
456,456,2014-1,5,14,14,0,16
457,457,2010-1,6,21,21,0,17
457,457,2010-2,6,21,21,0,17
457,457,2011-1,6,22,22,0,15
457,457,2011-2,6,22,22,0,15
457,457,2011-3,6,22,22,0,16
457,457,2012-1,6,22,22,0,16
457,457,2012-2,6,22,22,0,16
457,457,2013-1,6,22,22,0,16
457,457,2013-2,6,21,21,0,15
457,457,2013-3,7,21,21,0,15
458,458,2010-1,6,21,21,0,15
458,458,2010-2,6,21,21,0,15
458,458,2011-1,6,22,18,4,15
458,458,2011-2,5,20,20,0,15
458,458,2011-3,6,22,18,4,12
458,458,2012-1,5,17,4,13,6
458,458,2012-2,4,15,15,0,16
458,458,2013-1,6,22,12,10,13
458,458,2013-2,4,15,4,11,4
458,458,2013-3,6,22,8,14,11
458,458,2014-1,6,22,10,12,13
458,458,2015-1,6,21,4,17,4
458,458,2015-2,5,15,9,6,11
459,459,2010-1,6,21,21,0,15
459,459,2010-2,6,21,21,0,16
459,459,2011-1,6,22,22,0,16
459,459,2011-2,6,22,22,0,15
459,459,2011-3,6,22,22,0,16
459,459,2012-1,6,21,21,0,16
459,459,2012-2,6,22,22,0,17
459,459,2013-1,6,22,22,0,16
459,459,2013-2,6,22,22,0,16
459,459,2013-3,7,21,21,0,15
460,460,2010-1,6,21,18,3,15
460,460,2010-2,6,21,18,3,13
460,460,2010-C,1,3,3,0,14
460,460,2011-1,6,22,22,0,15
460,460,2011-2,6,22,19,3,15
460,460,2011-3,6,22,19,3,14
460,460,2012-1,6,21,21,0,15
460,460,2012-2,6,22,22,0,14
460,460,2013-1,6,22,22,0,14
460,460,2013-2,6,22,22,0,15
460,460,2013-3,7,21,17,4,13
460,460,2014-1,4,13,13,0,15
461,461,2010-1,6,21,17,4,14
461,461,2010-2,6,21,17,4,12
461,461,2011-1,6,22,14,8,12
461,461,2011-2,6,22,15,7,11
461,461,2011-3,6,21,3,18,6
461,461,2012-1,6,22,11,11,10
461,461,2012-2,6,20,13,7,11
461,461,2013-1,6,22,11,11,10
461,461,2013-2,4,15,0,15,6
461,461,2013-3,6,21,4,17,9
461,461,2014-1,4,14,0,14,2
461,461,2015-1,4,14,0,14,0
462,462,2010-1,6,21,21,0,15
462,462,2010-2,6,21,18,3,16
463,463,2010-1,6,21,6,15,8
463,463,2010-2,7,22,17,5,14
463,463,2011-2,4,15,15,0,14
463,463,2011-3,6,20,12,8,10
463,463,2012-1,5,14,0,14,5
463,463,2012-2,7,21,21,0,14
463,463,2013-1,6,22,10,12,10
463,463,2013-2,6,22,4,18,10
463,463,2013-3,6,22,11,11,12
463,463,2014-1,7,20,9,11,10
463,463,2014-2,6,15,6,9,11
463,463,2015-1,6,21,6,15,10
463,463,2015-2,10,26,15,11,11
464,464,2010-1,6,21,17,4,15
464,464,2010-2,6,21,21,0,15
464,464,2011-1,6,22,22,0,15
464,464,2011-2,5,20,20,0,15
464,464,2011-3,6,22,18,4,14
464,464,2012-1,6,21,21,0,15
464,464,2012-2,6,22,22,0,15
464,464,2013-1,6,20,20,0,17
464,464,2013-2,6,24,24,0,17
464,464,2013-3,7,22,22,0,15
464,464,2014-1,3,9,9,0,15
465,465,2010-1,6,21,21,0,15
465,465,2010-2,6,21,17,4,14
465,465,2011-1,6,22,18,4,14
465,465,2011-2,6,21,8,13,5
465,465,2011-3,3,11,11,0,15
465,465,2012-1,6,22,0,22,4
465,465,2012-2,6,22,15,7,11
465,465,2013-3,3,10,3,7,10
465,465,2014-1,6,21,21,0,15
465,465,2014-2,6,21,21,0,16
465,465,2015-1,3,10,10,0,16
465,465,2015-2,5,18,18,0,16
466,466,2010-1,6,21,13,8,13
466,466,2010-2,6,21,17,4,14
466,466,2011-1,4,13,5,8,12
466,466,2011-2,4,16,8,8,12
466,466,2011-3,4,13,13,0,14
466,466,2012-1,4,15,11,4,13
466,466,2012-2,6,22,10,12,13
466,466,2013-1,6,21,13,8,13
466,466,2013-2,6,20,1,19,10
466,466,2013-3,6,22,15,7,14
466,466,2014-1,7,21,18,3,14
466,466,2014-2,6,21,6,15,9
466,466,2015-1,7,22,7,15,11
466,466,2015-2,6,22,11,11,13
467,467,2010-1,6,21,21,0,16
467,467,2010-2,6,21,21,0,15
467,467,2011-1,6,22,22,0,15
467,467,2011-2,6,22,22,0,15
467,467,2011-3,6,22,22,0,15
467,467,2012-1,6,21,21,0,15
467,467,2012-2,5,19,19,0,17
467,467,2013-1,7,25,25,0,16
467,467,2013-2,6,22,22,0,15
467,467,2013-3,7,21,21,0,16
468,468,2010-1,7,22,22,0,16
469,469,2010-1,6,21,21,0,15
469,469,2010-2,6,21,21,0,15
469,469,2011-1,6,22,22,0,16
469,469,2011-2,6,22,22,0,15
469,469,2011-3,6,22,22,0,15
469,469,2012-1,6,21,21,0,16
469,469,2012-2,6,22,22,0,16
469,469,2013-1,6,22,22,0,17
469,469,2013-2,7,25,25,0,16
469,469,2013-3,7,21,21,0,16
470,470,2010-1,7,22,22,0,16
470,470,2010-2,7,21,9,12,8
470,470,2010-C,2,8,8,0,16
471,471,2010-1,6,21,21,0,15
471,471,2010-2,6,21,15,6,12
471,471,2011-1,6,22,4,18,7
471,471,2011-3,4,14,11,3,12
471,471,2012-1,7,22,18,4,13
471,471,2012-2,5,20,12,8,13
471,471,2013-1,6,22,12,10,12
471,471,2013-2,6,22,7,15,13
471,471,2013-3,6,21,11,10,12
471,471,2014-1,3,12,8,4,12
471,471,2014-2,4,15,15,0,14
471,471,2015-1,6,22,14,8,14
471,471,2015-2,5,20,8,12,10
472,472,2010-1,6,21,7,14,11
472,472,2010-2,5,18,4,14,10
472,472,2010-C,2,7,7,0,14
472,472,2011-1,5,18,4,14,7
472,472,2011-2,6,22,0,22,0
472,472,2011-3,6,22,0,22,1
472,472,2012-1,6,21,0,21,0
472,472,2012-2,6,20,0,20,1
472,472,2013-1,6,21,6,15,9
472,472,2013-2,4,15,4,11,4
472,472,2013-3,6,20,0,20,4
472,472,2014-1,7,20,16,4,12
472,472,2014-2,5,18,14,4,13
472,472,2015-1,4,16,0,16,3
472,472,2015-2,3,12,0,12,1
473,473,2010-1,6,21,13,8,12
473,473,2010-C,2,7,3,4,12
474,474,2010-1,6,20,20,0,15
474,474,2010-2,8,22,20,2,14
474,474,2011-1,7,22,22,0,16
474,474,2011-2,8,22,12,10,11
474,474,2011-3,7,22,15,7,12
474,474,2012-1,7,22,22,0,16
474,474,2012-2,7,22,22,0,16
474,474,2013-1,6,21,21,0,16
474,474,2013-2,2,11,11,0,15
476,476,2010-1,6,21,13,8,13
476,476,2010-2,7,22,8,14,11
476,476,2010-C,3,12,8,4,9
476,476,2011-2,6,21,13,8,12
476,476,2011-3,6,20,0,20,1
476,476,2012-2,4,15,11,4,12
476,476,2013-1,6,21,4,17,9
476,476,2013-2,6,20,1,19,7
476,476,2013-3,6,22,3,19,7
476,476,2014-1,4,15,0,15,10
476,476,2014-2,6,20,10,10,11
476,476,2015-1,6,20,10,10,9
477,477,2010-1,4,14,0,14,0
478,478,2010-1,7,22,18,4,13
478,478,2010-2,7,22,13,9,10
478,478,2011-1,6,19,5,14,9
479,479,2010-1,6,21,0,21,0
481,481,2010-1,6,21,21,0,15
481,481,2010-2,7,22,22,0,16
481,481,2010-C,3,11,0,11,0
481,481,2011-1,6,21,21,0,15
481,481,2011-2,6,22,15,7,14
481,481,2011-3,6,22,14,8,11
481,481,2012-1,6,21,13,8,12
481,481,2012-2,7,22,11,11,13
481,481,2013-1,8,22,17,5,14
481,481,2013-2,7,22,14,8,10
481,481,2013-3,8,22,14,8,12
481,481,2014-1,7,22,10,12,10
481,481,2014-2,7,21,10,11,11
481,481,2015-1,7,22,7,15,7
481,481,2015-2,6,22,7,15,12
482,482,2010-1,6,21,21,0,15
482,482,2010-2,6,22,22,0,14
482,482,2010-C,3,11,11,0,15
482,482,2011-1,6,22,14,8,14
482,482,2011-2,6,22,11,11,13
482,482,2011-3,6,21,18,3,14
482,482,2012-1,6,22,19,3,14
482,482,2012-2,5,20,20,0,15
482,482,2013-1,6,22,22,0,15
482,482,2013-2,6,22,22,0,15
482,482,2013-3,6,18,11,7,14
482,482,2014-1,8,25,25,0,16
483,483,2010-1,6,21,21,0,15
483,483,2010-2,6,21,21,0,16
483,483,2010-C,2,7,0,7,0
483,483,2011-1,6,22,22,0,15
483,483,2011-2,6,22,22,0,16
483,483,2011-3,6,22,22,0,16
483,483,2012-1,6,21,18,3,15
483,483,2012-2,6,21,18,3,16
483,483,2013-1,6,22,19,3,14
483,483,2013-2,6,22,22,0,16
483,483,2013-3,7,22,22,0,15
483,483,2014-1,3,9,9,0,16
484,484,2010-1,6,21,17,4,13
484,484,2010-2,6,21,18,3,14
484,484,2010-C,2,7,3,4,10
484,484,2011-1,6,22,10,12,11
484,484,2011-2,6,21,14,7,12
484,484,2011-3,6,21,21,0,15
484,484,2012-1,6,22,22,0,15
484,484,2012-2,6,22,22,0,15
484,484,2013-1,6,21,17,4,14
484,484,2013-2,5,20,20,0,14
484,484,2013-3,6,22,19,3,15
484,484,2014-1,6,21,21,0,15
484,484,2014-2,4,12,9,3,14
484,484,2015-1,1,3,3,0,15
485,485,2010-1,6,21,21,0,16
486,486,2010-1,6,21,21,0,16
486,486,2010-2,6,21,21,0,17
486,486,2011-1,6,22,22,0,15
486,486,2011-2,6,22,22,0,15
486,486,2011-3,6,22,22,0,15
486,486,2012-1,6,22,22,0,15
486,486,2012-2,6,22,22,0,15
486,486,2013-1,6,22,18,4,14
486,486,2013-2,6,22,22,0,16
486,486,2013-3,8,24,24,0,16
487,487,2010-1,6,21,21,0,15
487,487,2010-2,3,12,12,0,14
487,487,2010-C,3,11,11,0,15
487,487,2011-1,6,19,15,4,13
487,487,2011-2,6,21,21,0,15
487,487,2011-3,6,22,12,10,10
487,487,2012-1,6,20,13,7,10
487,487,2012-2,6,22,0,22,4
488,488,2010-1,6,21,17,4,12
488,488,2010-2,7,22,17,5,14
488,488,2011-1,6,18,8,10,8
488,488,2011-2,7,22,18,4,14
488,488,2011-3,5,19,15,4,14
488,488,2012-1,6,22,19,3,14
488,488,2012-2,7,22,9,13,10
488,488,2013-1,7,22,22,0,14
488,488,2013-2,7,22,22,0,14
488,488,2013-3,7,22,22,0,14
488,488,2014-1,6,22,14,8,14
488,488,2014-2,7,21,18,3,15
488,488,2015-1,3,15,7,8,13
488,488,2015-2,1,8,8,0,15
489,489,2010-1,6,20,13,7,12
489,489,2010-2,7,22,18,4,15
489,489,2010-C,3,12,12,0,16
489,489,2011-1,7,21,17,4,14
489,489,2011-2,6,21,21,0,15
489,489,2011-3,7,21,17,4,15
489,489,2012-1,6,21,21,0,15
489,489,2012-2,7,22,18,4,14
489,489,2013-1,7,22,22,0,15
489,489,2013-2,5,19,15,4,14
489,489,2013-3,2,12,12,0,16
490,490,2010-1,7,22,10,12,10
490,490,2010-2,7,22,12,10,11
490,490,2010-C,3,12,8,4,9
490,490,2011-1,4,14,7,7,11
490,490,2011-3,4,13,7,6,8
490,490,2012-1,6,21,15,6,12
490,490,2013-1,5,18,11,7,13
490,490,2013-2,4,14,6,8,11
490,490,2013-3,5,17,13,4,13
490,490,2014-1,5,18,10,8,13
490,490,2014-2,6,22,22,0,15
490,490,2015-1,5,19,19,0,14
490,490,2015-2,6,21,21,0,14
491,491,2010-1,7,22,2,20,6
491,491,2010-2,6,20,0,20,0
491,491,2010-C,3,10,0,10,0
492,492,2010-1,7,22,18,4,14
492,492,2010-2,7,22,16,6,13
492,492,2010-C,3,11,0,11,7
493,493,2010-1,6,21,3,18,10
493,493,2011-3,6,21,6,15,12
493,493,2012-1,6,21,11,10,10
493,493,2012-2,6,21,0,21,10
493,493,2013-1,6,21,0,21,7
493,493,2013-2,5,15,3,12,11
493,493,2014-1,4,14,10,4,13
493,493,2014-2,6,18,0,18,9
493,493,2015-1,5,15,1,14,9
494,494,2010-1,6,21,18,3,14
494,494,2010-2,6,21,13,8,11
494,494,2011-1,6,22,0,22,0
494,494,2013-1,6,22,11,11,8
494,494,2013-2,6,22,6,16,7
495,495,2010-1,6,21,21,0,15
495,495,2010-2,6,21,18,3,15
495,495,2011-1,6,22,18,4,15
495,495,2011-2,6,22,18,4,14
495,495,2011-3,6,22,18,4,14
495,495,2012-1,6,21,21,0,14
495,495,2012-2,6,21,21,0,15
495,495,2013-1,6,22,0,22,6
495,495,2013-3,3,12,12,0,15
495,495,2014-1,4,15,15,0,14
495,495,2014-2,4,15,11,4,13
495,495,2015-1,5,15,15,0,15
495,495,2015-2,4,15,15,0,15
496,496,2010-1,6,21,7,14,13
496,496,2010-2,6,21,7,14,9
496,496,2010-C,3,11,7,4,14
496,496,2011-1,6,22,0,22,2
496,496,2011-2,6,22,3,19,4
496,496,2011-3,6,21,0,21,2
497,497,2010-1,6,21,17,4,14
497,497,2010-2,6,21,13,8,14
497,497,2010-C,2,7,4,3,8
497,497,2011-1,6,22,14,8,11
497,497,2011-2,6,22,11,11,14
497,497,2011-3,5,19,12,7,12
497,497,2012-1,6,22,22,0,14
497,497,2012-2,6,22,22,0,14
497,497,2013-1,6,22,11,11,12
497,497,2013-2,6,22,11,11,13
497,497,2013-3,6,21,17,4,14
497,497,2014-1,4,15,7,8,13
497,497,2014-2,5,19,19,0,15
497,497,2015-1,6,21,18,3,15
497,497,2015-2,6,18,18,0,15
498,498,2010-1,6,21,14,7,14
498,498,2010-2,6,21,21,0,14
498,498,2011-1,6,22,18,4,14
498,498,2011-2,6,21,21,0,15
498,498,2011-3,6,22,22,0,15
498,498,2012-1,6,21,17,4,14
498,498,2012-2,6,22,22,0,14
498,498,2013-1,6,22,15,7,13
498,498,2013-2,4,15,11,4,13
498,498,2013-3,5,19,4,15,5
498,498,2014-1,6,22,7,15,10
498,498,2014-2,5,19,19,0,14
498,498,2015-1,6,19,16,3,13
498,498,2015-2,3,9,9,0,15
499,499,2010-1,6,21,13,8,13
499,499,2010-2,6,21,11,10,13
499,499,2010-C,3,11,4,7,9
499,499,2011-1,6,22,4,18,12
499,499,2011-2,6,22,14,8,13
499,499,2011-3,6,21,13,8,13
499,499,2012-1,6,22,22,0,14
499,499,2012-2,6,22,18,4,14
499,499,2013-1,6,21,17,4,14
499,499,2013-2,6,22,19,3,13
499,499,2013-3,5,20,16,4,13
499,499,2014-1,5,18,14,4,14
499,499,2014-2,6,20,20,0,14
500,500,2010-1,6,21,17,4,14
500,500,2010-2,6,21,11,10,10
500,500,2011-1,6,22,8,14,8
501,501,2010-1,6,21,13,8,13
501,501,2010-2,5,18,7,11,12
501,501,2010-C,3,11,11,0,14
501,501,2011-1,6,22,7,15,12
501,501,2011-2,6,22,11,11,13
501,501,2011-3,6,22,22,0,14
501,501,2012-1,6,22,11,11,12
501,501,2012-2,6,22,18,4,14
501,501,2013-1,6,22,11,11,11
501,501,2013-2,6,21,3,18,11
501,501,2013-3,3,12,4,8,13
501,501,2014-1,3,12,4,8,5
501,501,2014-2,3,11,11,0,14
501,501,2015-1,5,19,19,0,15
501,501,2015-2,6,22,22,0,14
502,502,2010-1,6,21,11,10,7
502,502,2010-C,3,11,3,8,9
502,502,2012-1,6,20,13,7,13
502,502,2012-2,6,21,13,8,13
502,502,2013-1,6,22,22,0,15
502,502,2013-2,6,22,22,0,15
502,502,2013-3,5,18,10,8,14
502,502,2014-1,5,20,12,8,12
502,502,2014-2,6,22,18,4,15
502,502,2015-1,6,22,8,14,8
503,503,2010-1,6,21,21,0,14
503,503,2010-2,6,21,17,4,12
503,503,2010-C,2,7,7,0,14
503,503,2011-1,6,22,14,8,14
503,503,2011-2,6,22,15,7,14
503,503,2011-3,6,21,21,0,15
503,503,2012-1,6,22,19,3,14
503,503,2012-2,5,18,18,0,15
503,503,2013-1,6,22,14,8,14
503,503,2013-2,6,22,22,0,14
503,503,2013-3,5,18,15,3,15
503,503,2014-1,6,22,22,0,16
503,503,2014-2,4,11,11,0,15
504,504,2010-1,6,21,14,7,15
504,504,2010-2,6,21,21,0,15
504,504,2010-C,3,11,7,4,14
504,504,2011-1,6,22,18,4,14
504,504,2011-2,6,22,22,0,15
504,504,2011-3,5,19,15,4,14
504,504,2012-1,6,21,11,10,14
504,504,2012-2,6,21,21,0,15
504,504,2013-1,6,22,14,8,13
504,504,2013-2,6,22,19,3,13
504,504,2013-3,6,21,17,4,15
504,504,2014-1,6,22,22,0,16
504,504,2014-2,5,15,15,0,15
505,505,2010-1,6,21,21,0,14
505,505,2010-2,6,21,13,8,11
505,505,2010-C,3,12,8,4,13
505,505,2011-1,6,22,18,4,12
505,505,2011-2,5,20,16,4,11
505,505,2011-3,5,18,15,3,15
505,505,2012-1,6,20,2,18,0
505,505,2012-2,6,22,18,4,12
505,505,2013-1,6,21,17,4,12
505,505,2013-2,6,22,0,22,2
505,505,2013-3,6,21,7,14,11
505,505,2014-2,4,15,15,0,16
505,505,2015-1,6,21,15,6,12
505,505,2015-2,6,21,21,0,15
506,506,2010-1,5,18,14,4,15
506,506,2010-2,6,22,22,0,15
506,506,2010-C,3,11,11,0,16
506,506,2011-1,5,19,19,0,15
506,506,2011-2,6,22,22,0,14
506,506,2011-3,6,22,22,0,15
506,506,2012-1,6,20,20,0,14
506,506,2012-2,6,22,22,0,14
506,506,2013-1,6,22,22,0,15
506,506,2013-2,7,22,22,0,15
506,506,2013-3,3,9,9,0,15
507,507,2010-1,6,21,18,3,16
507,507,2010-2,6,21,21,0,16
507,507,2010-C,2,7,7,0,18
507,507,2011-1,6,22,22,0,15
507,507,2011-2,6,22,22,0,16
507,507,2011-3,6,21,21,0,16
507,507,2012-1,6,20,20,0,16
507,507,2012-2,6,22,22,0,16
507,507,2013-1,6,22,22,0,16
507,507,2013-2,6,22,22,0,15
507,507,2013-3,7,22,22,0,16
508,508,2010-1,6,21,17,4,14
508,508,2010-2,6,22,15,7,14
508,508,2010-C,3,11,11,0,15
508,508,2011-1,6,21,21,0,15
508,508,2011-2,6,22,22,0,14
508,508,2011-3,6,22,7,15,10
508,508,2012-1,6,22,4,18,10
508,508,2012-2,6,22,4,18,6
508,508,2013-1,6,22,7,15,10
508,508,2013-2,6,21,14,7,13
508,508,2013-3,6,22,11,11,10
508,508,2014-1,6,22,3,19,9
508,508,2014-2,6,22,0,22,0
508,508,2015-1,6,21,21,0,14
508,508,2015-2,6,22,19,3,14
509,509,2010-1,6,21,21,0,15
509,509,2010-2,6,21,18,3,14
509,509,2011-1,6,22,11,11,13
509,509,2011-2,6,21,8,13,11
509,509,2011-3,6,22,4,18,6
509,509,2012-1,6,22,8,14,6
509,509,2013-3,6,21,17,4,14
509,509,2014-1,5,20,12,8,14
509,509,2014-2,5,18,3,15,10
509,509,2015-1,6,22,8,14,7
510,510,2010-1,6,21,21,0,15
510,510,2010-2,6,21,21,0,15
510,510,2011-1,6,22,18,4,14
510,510,2011-2,6,22,22,0,15
510,510,2011-3,6,22,18,4,14
510,510,2012-1,6,21,21,0,14
510,510,2012-2,4,14,14,0,16
510,510,2013-1,6,22,18,4,14
510,510,2013-2,6,22,22,0,15
510,510,2013-3,4,15,15,0,15
510,510,2014-1,7,22,22,0,15
510,510,2014-2,3,10,10,0,15
511,511,2010-1,6,21,21,0,15
511,511,2010-2,6,22,14,8,11
511,511,2010-C,3,11,11,0,14
511,511,2011-1,6,22,4,18,6
511,511,2011-2,6,22,11,11,9
511,511,2011-3,6,21,3,18,2
511,511,2012-1,6,21,0,21,0
511,511,2012-2,6,22,4,18,8
511,511,2013-1,6,22,12,10,10
512,512,2010-1,6,21,13,8,11
512,512,2010-2,6,21,15,6,14
513,513,2010-1,6,21,17,4,15
513,513,2010-2,6,21,14,7,14
513,513,2010-C,2,7,7,0,15
513,513,2011-1,6,22,10,12,9
513,513,2011-2,5,20,12,8,13
513,513,2011-3,6,22,16,6,15
513,513,2012-1,6,22,14,8,11
513,513,2012-2,6,22,8,14,12
513,513,2013-1,5,18,3,15,5
513,513,2013-2,6,21,0,21,6
513,513,2013-3,6,21,7,14,6
513,513,2014-1,6,22,0,22,7
514,514,2010-1,6,21,0,21,0
515,515,2010-1,6,21,0,21,0
516,516,2010-1,6,21,10,11,12
516,516,2011-1,6,21,7,14,10
516,516,2011-2,6,21,0,21,4
516,516,2011-3,6,21,0,21,0
516,516,2012-1,6,21,3,18,2
517,517,2010-1,6,21,21,0,14
517,517,2010-2,6,22,22,0,15
517,517,2010-C,3,12,12,0,15
517,517,2011-1,6,22,22,0,14
517,517,2011-2,6,22,15,7,14
517,517,2011-3,7,22,19,3,14
517,517,2012-1,6,20,20,0,14
517,517,2012-2,6,22,18,4,14
517,517,2013-1,6,22,18,4,13
517,517,2013-2,5,19,19,0,15
517,517,2013-3,6,21,21,0,16
517,517,2014-1,3,9,9,0,16
518,518,2010-1,3,11,11,0,14
518,518,2010-2,6,21,21,0,15
518,518,2011-1,6,22,22,0,15
518,518,2011-2,6,22,22,0,15
518,518,2011-3,6,22,22,0,14
518,518,2012-1,6,21,21,0,14
518,518,2012-2,6,22,10,12,11
518,518,2013-1,6,22,22,0,14
518,518,2013-2,5,20,20,0,15
518,518,2013-3,7,22,22,0,15
518,518,2014-1,4,13,13,0,15
519,519,2010-1,6,21,21,0,15
519,519,2010-2,6,22,22,0,15
519,519,2010-C,3,12,12,0,15
519,519,2011-1,6,22,22,0,14
519,519,2011-2,6,22,18,4,14
519,519,2011-3,7,22,19,3,14
519,519,2012-1,6,22,14,8,9
519,519,2012-2,6,22,18,4,14
519,519,2013-1,6,22,22,0,15
519,519,2013-2,3,11,11,0,14
519,519,2013-3,6,21,21,0,15
519,519,2014-1,5,16,16,0,16
520,520,2010-1,2,7,4,3,9
520,520,2010-2,6,21,17,4,15
520,520,2011-1,5,19,19,0,15
520,520,2011-2,6,22,11,11,9
520,520,2011-3,6,22,8,14,12
520,520,2012-1,6,22,14,8,13
520,520,2012-2,5,20,16,4,15
520,520,2013-1,6,22,18,4,13
520,520,2013-2,6,20,20,0,15
520,520,2013-3,6,22,22,0,15
520,520,2014-1,3,11,11,0,16
520,520,2014-2,4,13,13,0,15
521,521,2010-1,6,21,7,14,12
521,521,2010-2,6,21,4,17,5
521,521,2011-1,6,20,3,17,7
521,521,2011-2,6,21,0,21,0
522,522,2010-1,6,21,18,3,14
522,522,2010-2,6,21,13,8,9
522,522,2010-C,3,11,11,0,15
522,522,2011-1,6,22,22,0,14
522,522,2011-2,6,22,22,0,15
522,522,2011-3,6,22,22,0,15
522,522,2012-1,6,21,21,0,14
522,522,2012-2,6,22,14,8,14
522,522,2013-1,6,21,17,4,14
522,522,2013-2,4,16,8,8,14
522,522,2013-3,5,18,14,4,13
522,522,2014-1,6,21,14,7,14
522,522,2014-2,6,20,16,4,14
522,522,2015-1,1,4,4,0,17
523,523,2010-1,6,21,0,21,0
524,524,2010-1,6,21,18,3,14
525,525,2010-1,6,21,21,0,14
525,525,2010-2,6,21,21,0,15
525,525,2010-C,3,12,12,0,14
525,525,2011-1,6,22,22,0,15
525,525,2011-2,6,22,14,8,13
525,525,2011-3,6,22,19,3,14
525,525,2012-1,6,21,17,4,14
525,525,2012-2,6,20,20,0,14
525,525,2013-1,5,18,14,4,14
525,525,2013-2,5,19,19,0,14
525,525,2013-3,4,13,13,0,15
525,525,2014-1,5,18,18,0,15
525,525,2014-2,2,6,6,0,15
526,526,2010-1,6,21,17,4,15
526,526,2010-2,6,21,18,3,14
526,526,2010-C,2,7,7,0,16
526,526,2011-1,6,22,18,4,14
526,526,2011-2,6,22,22,0,15
526,526,2011-3,6,22,11,11,13
526,526,2012-1,6,21,21,0,14
526,526,2012-2,6,22,22,0,14
526,526,2013-1,6,21,10,11,13
526,526,2013-2,6,21,21,0,15
526,526,2013-3,4,15,15,0,15
526,526,2014-1,6,21,21,0,15
526,526,2014-2,4,13,9,4,14
526,526,2015-1,1,4,4,0,15
527,527,2010-1,3,11,11,0,14
527,527,2010-2,6,21,21,0,16
527,527,2011-1,6,22,22,0,16
527,527,2011-2,6,22,22,0,15
527,527,2011-3,6,22,22,0,16
527,527,2012-1,6,21,21,0,15
527,527,2012-2,6,22,22,0,15
527,527,2013-1,6,22,22,0,17
527,527,2013-2,6,22,22,0,15
527,527,2013-3,8,24,24,0,16
528,528,2010-1,6,21,14,7,14
528,528,2010-2,6,21,17,4,14
528,528,2011-1,6,22,18,4,14
528,528,2011-2,6,22,22,0,15
528,528,2011-3,6,22,22,0,15
528,528,2012-1,6,20,17,3,14
528,528,2012-2,6,21,21,0,14
528,528,2013-1,6,22,14,8,13
528,528,2013-2,6,22,22,0,14
528,528,2013-3,6,22,7,15,11
528,528,2014-2,6,21,0,21,3
529,529,2010-1,6,21,21,0,17
529,529,2010-2,6,22,22,0,17
529,529,2010-C,2,7,7,0,18
529,529,2011-1,6,22,22,0,16
529,529,2011-2,6,22,22,0,16
529,529,2011-3,6,21,21,0,15
529,529,2012-1,6,20,20,0,15
529,529,2012-2,6,22,22,0,17
529,529,2013-1,5,17,17,0,16
529,529,2013-2,4,15,15,0,15
529,529,2013-3,4,14,14,0,15
529,529,2014-1,4,13,13,0,15
530,530,2010-1,6,21,0,21,0
531,531,2010-1,6,21,10,11,12
532,532,2010-1,6,21,0,21,0
532,532,2011-2,6,21,0,21,1
532,532,2011-3,6,21,17,4,13
532,532,2012-1,6,21,18,3,13
532,532,2012-2,6,21,8,13,7
532,532,2013-1,6,21,14,7,12
532,532,2013-2,6,20,0,20,5
533,533,2010-1,6,21,0,21,0
533,533,2010-2,6,21,21,0,14
533,533,2011-1,6,21,11,10,13
533,533,2011-2,6,22,15,7,13
533,533,2011-3,6,21,11,10,8
533,533,2012-1,6,21,14,7,12
533,533,2012-2,6,20,17,3,13
533,533,2013-1,6,21,11,10,8
533,533,2013-2,6,21,14,7,13
533,533,2013-3,6,22,15,7,12
533,533,2014-1,6,22,22,0,15
533,533,2014-2,6,22,22,0,15
533,533,2015-1,7,22,22,0,15
533,533,2015-2,3,11,11,0,15
534,534,2010-1,6,21,21,0,15
534,534,2010-2,6,21,15,6,13
535,535,2010-1,6,21,21,0,15
535,535,2010-2,6,22,15,7,14
535,535,2010-C,3,11,11,0,16
535,535,2011-1,6,22,18,4,15
535,535,2011-2,6,22,18,4,14
535,535,2011-3,6,22,11,11,11
535,535,2012-1,6,21,17,4,14
535,535,2012-2,5,18,18,0,15
535,535,2013-1,6,22,11,11,14
535,535,2013-2,6,22,22,0,15
535,535,2013-3,6,21,14,7,14
535,535,2014-2,6,21,21,0,15
535,535,2015-1,6,19,7,12,10
535,535,2015-2,2,6,0,6,5
536,536,2010-1,6,21,13,8,11
536,536,2010-2,6,21,0,21,3
536,536,2010-C,3,11,11,0,14
536,536,2011-1,6,21,10,11,10
537,537,2010-1,6,21,0,21,2
537,537,2010-2,6,21,18,3,14
537,537,2011-1,6,21,0,21,12
537,537,2011-3,6,21,0,21,6
537,537,2012-2,6,21,17,4,14
537,537,2013-3,6,20,13,7,13
537,537,2014-1,6,19,12,7,13
537,537,2014-2,5,18,18,0,15
537,537,2015-1,5,19,15,4,14
537,537,2015-2,5,17,13,4,15
538,538,2010-1,6,21,21,0,17
538,538,2010-2,6,21,21,0,17
538,538,2011-1,6,22,18,4,15
538,538,2011-2,6,22,22,0,17
538,538,2011-3,6,22,22,0,16
538,538,2012-1,6,22,22,0,15
538,538,2012-2,6,22,22,0,16
538,538,2013-1,6,21,21,0,15
538,538,2013-2,5,18,18,0,16
538,538,2013-3,6,19,19,0,15
538,538,2014-1,3,10,10,0,17
539,539,2010-1,6,21,0,21,0
539,539,2011-1,3,11,11,0,14
539,539,2011-2,6,21,6,15,9
539,539,2011-3,6,21,6,15,13
539,539,2012-1,6,21,14,7,13
539,539,2012-2,6,21,21,0,15
539,539,2013-1,5,20,8,12,13
539,539,2013-2,6,22,22,0,14
539,539,2013-3,6,22,8,14,11
539,539,2014-1,5,19,15,4,14
539,539,2014-2,6,22,16,6,11
539,539,2015-1,6,20,7,13,8
539,539,2015-2,6,22,22,0,15
540,540,2010-1,6,21,6,15,4
540,540,2010-2,6,21,18,3,12
540,540,2010-C,2,7,3,4,6
540,540,2011-1,6,21,18,3,14
540,540,2011-2,6,22,12,10,11
540,540,2011-3,4,14,0,14,3
540,540,2012-1,6,21,4,17,6
540,540,2012-2,6,22,22,0,14
540,540,2013-1,6,22,11,11,10
540,540,2013-2,6,22,4,18,7
540,540,2013-3,6,22,4,18,5
540,540,2014-1,5,19,15,4,13
540,540,2014-2,4,14,4,10,8
540,540,2015-1,5,18,4,14,5
541,541,2010-1,6,21,6,15,13
541,541,2010-2,6,21,15,6,13
541,541,2011-1,6,21,3,18,12
541,541,2011-2,6,21,7,14,12
541,541,2011-3,6,22,18,4,14
541,541,2012-1,6,22,0,22,3
541,541,2012-2,6,22,0,22,6
541,541,2013-1,6,22,6,16,7
541,541,2013-2,4,16,0,16,8
541,541,2013-3,5,19,11,8,12
541,541,2014-1,6,22,15,7,12
541,541,2014-2,5,20,8,12,8
541,541,2015-1,6,20,11,9,14
541,541,2015-2,6,20,16,4,13
542,542,2010-1,6,21,14,7,13
542,542,2010-2,6,21,4,17,12
542,542,2010-C,3,11,7,4,14
542,542,2011-1,6,21,4,17,5
542,542,2011-3,6,21,6,15,13
542,542,2012-1,6,21,18,3,15
542,542,2012-2,6,22,22,0,14
542,542,2013-1,6,22,19,3,13
542,542,2013-2,6,22,18,4,15
542,542,2013-3,4,14,11,3,14
542,542,2014-1,6,22,22,0,15
542,542,2014-2,5,19,19,0,16
542,542,2015-1,6,22,22,0,16
542,542,2015-2,6,19,19,0,16
543,543,2010-1,6,21,21,0,15
543,543,2010-2,6,22,22,0,15
543,543,2010-C,3,12,12,0,16
543,543,2011-1,6,22,18,4,14
543,543,2011-2,6,22,22,0,14
543,543,2011-3,7,22,22,0,15
543,543,2012-1,5,18,11,7,10
543,543,2012-2,6,22,22,0,14
543,543,2013-1,6,22,16,6,14
543,543,2013-2,6,22,18,4,12
543,543,2013-3,4,14,14,0,15
543,543,2014-1,6,18,18,0,16
544,544,2010-1,6,21,21,0,14
544,544,2010-2,6,21,17,4,12
544,544,2010-C,3,11,11,0,15
544,544,2011-1,6,21,13,8,9
544,544,2011-2,4,15,0,15,1
544,544,2011-3,6,21,6,15,6
544,544,2012-1,6,21,4,17,5
544,544,2012-2,6,22,7,15,8
544,544,2013-1,6,22,0,22,7
544,544,2013-2,6,22,11,11,10
544,544,2013-3,5,19,0,19,6
544,544,2014-1,5,20,4,16,6
545,545,2010-1,6,21,21,0,15
545,545,2010-2,6,21,21,0,16
545,545,2011-1,6,22,22,0,16
545,545,2011-2,6,22,22,0,16
545,545,2011-3,6,22,22,0,15
545,545,2012-1,6,21,17,4,15
545,545,2012-2,6,20,20,0,16
545,545,2013-1,6,22,22,0,16
545,545,2013-2,5,19,19,0,15
545,545,2013-3,6,22,22,0,15
545,545,2014-1,3,8,8,0,15
546,546,2010-1,6,21,21,0,15
546,546,2010-2,6,21,21,0,16
546,546,2011-1,6,22,22,0,15
546,546,2011-2,6,22,22,0,15
546,546,2011-3,6,22,18,4,15
546,546,2012-1,6,22,22,0,16
546,546,2012-2,6,22,19,3,15
546,546,2013-1,6,22,18,4,15
546,546,2013-2,6,22,18,4,14
546,546,2013-3,7,22,22,0,14
546,546,2014-1,4,13,9,4,14
546,546,2014-2,1,4,4,0,14
547,547,2010-1,6,21,13,8,14
547,547,2010-2,6,21,18,3,14
547,547,2011-1,6,22,10,12,12
547,547,2011-2,6,22,15,7,14
547,547,2011-3,6,22,19,3,14
547,547,2012-1,6,22,18,4,14
547,547,2012-2,6,22,18,4,14
547,547,2013-1,6,21,17,4,14
547,547,2013-2,6,21,21,0,14
547,547,2013-3,4,15,15,0,14
547,547,2014-1,5,19,11,8,14
547,547,2014-2,6,19,16,3,15
547,547,2015-1,6,21,21,0,15
547,547,2015-2,3,10,10,0,16
548,548,2010-1,6,21,13,8,14
548,548,2010-C,3,11,7,4,13
548,548,2011-1,6,21,0,21,2
548,548,2011-3,6,21,0,21,0
549,549,2010-1,6,21,3,18,4
550,550,2010-1,6,21,0,21,0
551,551,2010-1,6,21,13,8,14
551,551,2010-2,6,21,17,4,14
551,551,2011-1,6,22,18,4,12
551,551,2011-2,6,22,10,12,9
551,551,2011-3,6,22,18,4,14
551,551,2012-1,6,22,7,15,7
551,551,2012-2,6,22,10,12,10
551,551,2013-1,5,20,12,8,12
551,551,2013-2,6,22,7,15,12
551,551,2013-3,6,22,4,18,4
551,551,2014-1,6,22,22,0,14
551,551,2014-2,5,20,20,0,15
551,551,2015-1,6,21,21,0,15
551,551,2015-2,4,13,10,3,12
552,552,2010-1,6,21,14,7,13
552,552,2010-2,6,21,17,4,12
552,552,2011-1,6,21,17,4,14
552,552,2011-2,6,21,21,0,16
552,552,2011-3,6,22,22,0,15
552,552,2012-1,6,22,18,4,12
552,552,2012-2,6,22,22,0,15
552,552,2013-1,6,22,22,0,14
552,552,2013-2,6,22,22,0,16
552,552,2013-3,6,21,21,0,15
552,552,2014-1,6,20,20,0,15
553,553,2010-1,6,21,17,4,14
553,553,2010-2,6,21,21,0,15
553,553,2011-1,6,22,22,0,15
553,553,2011-2,6,22,22,0,15
553,553,2011-3,5,19,19,0,15
553,553,2012-1,6,21,21,0,15
553,553,2012-2,5,17,17,0,15
553,553,2013-1,6,22,11,11,11
553,553,2013-2,6,22,11,11,10
553,553,2014-1,5,20,16,4,14
553,553,2014-2,5,17,14,3,13
553,553,2015-1,6,19,19,0,15
553,553,2015-2,2,6,6,0,14
554,554,2010-1,3,11,3,8,13
554,554,2010-2,6,21,17,4,11
554,554,2011-1,6,21,8,13,11
554,554,2011-2,6,22,22,0,14
554,554,2011-3,4,15,15,0,14
554,554,2012-2,6,22,14,8,13
554,554,2013-1,6,22,18,4,12
554,554,2013-2,6,22,15,7,13
554,554,2013-3,5,17,6,11,12
554,554,2014-1,4,15,11,4,13
554,554,2014-2,5,20,20,0,15
554,554,2015-1,6,22,18,4,13
554,554,2015-2,4,13,6,7,12
555,555,2010-1,6,21,7,14,12
555,555,2010-C,3,11,0,11,0
556,556,2010-1,6,21,21,0,15
556,556,2010-2,6,21,17,4,15
556,556,2010-C,3,12,12,0,15
556,556,2011-1,6,22,10,12,7
556,556,2011-2,6,22,10,12,8
556,556,2011-3,6,22,11,11,7
556,556,2012-1,6,21,18,3,12
556,556,2012-2,6,22,8,14,11
556,556,2013-1,6,22,18,4,14
556,556,2013-2,6,22,18,4,14
556,556,2013-3,5,19,19,0,15
556,556,2014-1,6,21,21,0,16
556,556,2014-2,5,18,14,4,14
557,557,2010-1,6,21,21,0,15
557,557,2010-2,6,21,17,4,15
557,557,2010-C,3,11,11,0,16
557,557,2011-1,6,21,21,0,15
557,557,2011-2,6,22,22,0,15
557,557,2011-3,6,22,22,0,14
557,557,2012-1,6,21,17,4,15
557,557,2012-2,6,22,22,0,14
557,557,2013-1,6,22,22,0,14
557,557,2013-2,5,19,19,0,15
557,557,2013-3,6,19,19,0,15
557,557,2014-1,2,6,3,3,8
558,558,2010-1,6,21,13,8,14
558,558,2010-2,7,22,17,5,14
558,558,2011-1,3,12,0,12,5
558,558,2011-2,2,8,4,4,13
558,558,2011-3,6,20,17,3,13
558,558,2012-1,6,20,5,15,6
558,558,2012-2,6,22,11,11,12
558,558,2013-1,6,22,18,4,15
558,558,2013-2,6,22,14,8,10
558,558,2013-3,8,22,15,7,11
558,558,2014-1,6,20,6,14,9
558,558,2014-2,6,21,14,7,12
558,558,2015-1,6,22,14,8,12
558,558,2015-2,7,21,18,3,15
559,559,2011-2,3,10,10,0,15
559,559,2011-3,7,22,22,0,16
559,559,2012-1,7,21,21,0,15
559,559,2012-2,6,22,18,4,14
559,559,2013-1,6,22,8,14,12
559,559,2013-2,6,20,13,7,11
559,559,2013-3,7,21,21,0,16
559,559,2014-1,6,22,18,4,13
559,559,2014-2,7,22,21,1,15
559,559,2015-1,7,22,19,3,12
559,559,2015-2,3,14,14,0,16
560,560,2010-1,6,21,17,4,14
560,560,2010-2,6,22,10,12,10
560,560,2010-C,3,11,7,4,12
560,560,2011-1,6,22,10,12,8
560,560,2011-2,6,21,14,7,11
560,560,2011-3,6,22,3,19,7
560,560,2012-1,6,22,4,18,6
560,560,2012-2,6,22,11,11,10
560,560,2013-1,6,21,6,15,7
560,560,2013-2,6,22,22,0,15
560,560,2013-3,6,22,11,11,11
560,560,2014-1,5,20,16,4,14
560,560,2014-2,5,20,20,0,14
560,560,2015-1,6,22,22,0,15
560,560,2015-2,6,22,22,0,14
561,561,2010-1,7,22,22,0,15
561,561,2010-2,7,21,0,21,1
561,561,2010-C,3,11,8,3,14
563,563,2010-1,7,22,13,9,13
563,563,2010-2,7,22,22,0,15
563,563,2010-C,3,11,8,3,12
563,563,2011-1,6,21,21,0,15
563,563,2011-2,6,22,22,0,16
563,563,2011-3,6,21,21,0,16
563,563,2012-1,7,22,22,0,15
563,563,2012-2,7,22,22,0,16
563,563,2013-1,7,22,19,3,14
563,563,2013-2,7,22,22,0,16
563,563,2013-3,6,24,24,0,15
564,564,2010-1,7,22,14,8,13
564,564,2010-2,6,19,15,4,12
565,565,2010-1,6,21,0,21,3
566,566,2010-1,6,21,21,0,16
566,566,2010-2,6,22,22,0,16
566,566,2010-C,3,12,12,0,15
566,566,2011-1,6,22,22,0,15
566,566,2011-2,6,22,22,0,15
566,566,2011-3,6,21,21,0,16
566,566,2012-1,6,22,22,0,15
566,566,2012-2,6,22,22,0,15
566,566,2013-1,6,22,22,0,15
566,566,2013-2,7,21,14,7,13
566,566,2013-3,5,16,9,7,11
567,567,2010-1,6,21,18,3,14
567,567,2010-2,7,22,22,0,16
567,567,2010-C,3,11,7,4,9
567,567,2011-1,6,22,11,11,13
567,567,2011-2,7,22,17,5,14
567,567,2012-1,7,21,10,11,10
567,567,2012-2,6,19,12,7,13
567,567,2013-1,6,22,11,11,10
567,567,2013-2,7,22,8,14,12
567,567,2013-3,6,21,3,18,10
567,567,2014-1,6,21,10,11,12
567,567,2014-2,7,22,19,3,14
567,567,2015-1,7,22,22,0,14
567,567,2015-2,6,22,7,15,12
568,568,2010-1,6,21,21,0,16
568,568,2010-2,6,21,21,0,15
568,568,2010-C,3,11,7,4,15
568,568,2011-1,6,22,18,4,13
568,568,2011-2,6,22,22,0,15
568,568,2011-3,6,22,19,3,14
568,568,2012-1,6,22,22,0,15
568,568,2012-2,6,22,19,3,14
568,568,2013-1,6,22,22,0,15
568,568,2013-2,6,21,21,0,16
568,568,2013-3,8,24,24,0,15
569,569,2010-1,6,21,21,0,17
569,569,2010-2,6,22,22,0,16
569,569,2010-C,3,11,11,0,18
569,569,2011-1,6,22,22,0,16
569,569,2011-2,6,22,22,0,16
569,569,2011-3,6,22,22,0,16
569,569,2012-1,6,22,22,0,16
569,569,2012-2,6,22,22,0,16
569,569,2013-1,6,22,22,0,16
569,569,2013-2,7,21,21,0,16
569,569,2013-3,3,9,9,0,15
570,570,2010-1,6,22,14,8,12
570,570,2010-2,6,22,15,7,14
570,570,2010-C,3,10,10,0,15
570,570,2011-1,6,22,18,4,15
570,570,2011-2,6,22,18,4,12
570,570,2011-3,6,22,22,0,16
570,570,2012-1,6,22,22,0,15
570,570,2012-2,6,22,22,0,16
570,570,2013-1,6,22,22,0,15
570,570,2013-2,6,22,22,0,15
570,570,2013-3,4,12,12,0,16
571,571,2010-1,6,21,21,0,15
571,571,2010-2,6,22,22,0,14
571,571,2010-C,3,12,12,0,15
571,571,2011-1,6,22,22,0,16
571,571,2011-2,6,22,22,0,17
571,571,2011-3,6,21,21,0,16
571,571,2012-1,6,22,18,4,16
571,571,2012-2,6,22,22,0,15
571,571,2013-1,6,22,22,0,15
571,571,2013-2,7,22,22,0,15
571,571,2013-3,4,12,12,0,16
572,572,2010-1,6,21,17,4,14
572,572,2010-2,6,22,22,0,15
572,572,2010-C,3,11,11,0,18
572,572,2011-1,6,22,22,0,15
572,572,2011-2,6,22,22,0,14
572,572,2011-3,6,22,18,4,14
572,572,2012-1,6,22,15,7,14
572,572,2012-2,6,21,21,0,15
572,572,2013-1,6,22,22,0,15
572,572,2013-2,6,21,17,4,15
572,572,2013-3,7,22,22,0,16
572,572,2014-1,2,7,7,0,15
573,573,2010-1,6,21,17,4,14
573,573,2010-2,6,21,21,0,14
573,573,2010-C,3,11,7,4,9
573,573,2011-1,6,22,10,12,13
573,573,2011-2,6,22,18,4,13
573,573,2011-3,6,22,14,8,13
573,573,2012-1,6,22,15,7,14
573,573,2012-2,6,22,22,0,14
573,573,2013-1,6,22,22,0,15
573,573,2013-2,6,22,22,0,15
573,573,2013-3,6,22,18,4,14
573,573,2014-1,7,22,19,3,15
573,573,2014-2,4,14,11,3,13
574,574,2010-1,6,21,21,0,15
574,574,2010-2,6,22,22,0,14
574,574,2010-C,3,11,7,4,9
574,574,2011-1,7,22,14,8,14
574,574,2011-2,6,22,18,4,14
574,574,2011-3,6,21,21,0,14
574,574,2012-1,7,22,14,8,12
574,574,2012-2,7,21,17,4,13
574,574,2013-1,6,21,18,3,14
574,574,2013-2,7,21,21,0,16
574,574,2013-3,6,22,18,4,14
574,574,2014-1,5,22,18,4,15
574,574,2014-2,2,7,7,0,14
575,575,2010-1,6,22,15,7,15
575,575,2010-2,6,21,21,0,16
575,575,2011-1,7,21,13,8,13
575,575,2011-2,6,22,22,0,15
575,575,2011-3,7,21,14,7,13
575,575,2012-1,6,20,20,0,15
575,575,2012-2,7,21,20,1,14
575,575,2013-1,7,22,22,0,15
575,575,2013-2,6,21,18,3,14
575,575,2013-3,5,21,10,11,11
575,575,2014-1,1,8,8,0,16
576,576,2010-1,6,21,17,4,14
576,576,2010-2,7,20,20,0,15
576,576,2010-C,3,11,11,0,17
576,576,2011-1,5,20,20,0,15
576,576,2011-2,6,21,21,0,14
576,576,2011-3,6,22,22,0,15
576,576,2012-1,8,22,22,0,16
576,576,2012-2,7,22,18,4,15
576,576,2013-1,7,22,22,0,15
576,576,2013-2,6,22,22,0,16
576,576,2013-3,5,21,21,0,15
577,577,2010-1,7,22,22,0,15
577,577,2010-2,7,22,22,0,14
577,577,2010-C,3,9,9,0,16
577,577,2011-1,7,22,22,0,14
577,577,2011-2,5,16,16,0,14
577,577,2011-3,5,21,17,4,12
577,577,2012-1,7,22,9,13,13
577,577,2012-2,6,19,19,0,15
577,577,2013-1,7,22,22,0,14
577,577,2013-2,7,22,19,3,14
577,577,2013-3,7,22,15,7,11
577,577,2014-1,7,23,12,11,11
577,577,2014-2,3,11,11,0,14
578,578,2010-1,6,21,13,8,13
578,578,2010-2,4,15,8,7,14
578,578,2010-C,2,7,3,4,12
578,578,2011-1,6,22,18,4,13
578,578,2011-2,6,22,8,14,10
578,578,2011-3,6,22,15,7,13
578,578,2012-1,6,22,3,19,11
578,578,2012-2,6,22,11,11,11
578,578,2013-1,6,22,10,12,12
578,578,2013-2,5,20,4,16,9
578,578,2013-3,6,22,14,8,13
578,578,2014-2,6,22,4,18,5
578,578,2015-1,6,22,3,19,9
579,579,2010-1,7,22,6,16,8
579,579,2010-2,6,20,6,14,9
579,579,2010-C,2,6,2,4,5
579,579,2011-1,6,19,10,9,12
579,579,2011-2,6,19,12,7,13
579,579,2011-3,5,15,12,3,15
579,579,2012-1,6,21,6,15,10
579,579,2012-2,4,15,11,4,10
579,579,2013-3,5,19,15,4,14
579,579,2014-1,5,19,11,8,11
579,579,2014-2,2,8,4,4,13
579,579,2015-1,5,15,0,15,6
579,579,2015-2,6,19,7,12,11
580,580,2010-1,6,21,21,0,15
580,580,2010-2,6,21,17,4,12
580,580,2010-C,3,11,0,11,0
580,580,2011-1,6,22,14,8,13
580,580,2011-2,6,22,0,22,1
580,580,2011-3,6,21,0,21,1
580,580,2012-1,6,21,6,15,6
580,580,2012-2,5,19,0,19,6
580,580,2013-1,6,22,3,19,8
580,580,2013-2,5,20,0,20,2
580,580,2014-1,5,20,0,20,1
581,581,2010-1,6,21,9,12,11
581,581,2010-2,6,21,6,15,6
582,582,2010-1,6,21,17,4,14
583,583,2010-1,6,21,18,3,14
584,584,2010-1,6,21,21,0,15
584,584,2010-2,6,21,21,0,14
584,584,2011-1,6,22,10,12,12
584,584,2011-2,6,21,21,0,15
584,584,2011-3,6,22,18,4,13
584,584,2012-1,6,22,15,7,13
584,584,2012-2,6,22,22,0,14
584,584,2013-1,6,22,14,8,13
584,584,2013-2,6,22,18,4,14
584,584,2013-3,4,14,10,4,15
584,584,2014-1,6,22,19,3,15
584,584,2014-2,6,20,20,0,15
584,584,2015-1,4,13,13,0,14
585,585,2010-1,6,21,13,8,12
585,585,2010-2,6,22,18,4,14
585,585,2010-C,3,11,11,0,15
585,585,2011-1,7,22,18,4,14
585,585,2011-2,6,22,19,3,12
585,585,2011-3,7,22,18,4,13
585,585,2012-1,6,22,11,11,10
585,585,2012-2,7,21,14,7,11
585,585,2013-1,7,22,22,0,16
585,585,2013-2,7,22,22,0,15
585,585,2013-3,6,22,22,0,15
585,585,2014-1,6,20,16,4,15
585,585,2014-2,2,12,12,0,17
586,586,2010-1,7,22,19,3,14
586,586,2011-1,7,22,0,22,0
587,587,2010-1,7,22,0,22,0
588,588,2010-1,6,21,17,4,14
588,588,2010-2,7,22,18,4,14
588,588,2010-C,3,11,8,3,13
588,588,2011-1,6,21,20,1,14
589,589,2010-1,7,22,0,22,0
589,589,2010-2,7,22,5,17,4
589,589,2011-1,6,20,4,16,3
589,589,2011-2,7,22,0,22,1
589,589,2011-3,7,22,0,22,2
589,589,2012-1,6,19,3,16,3
589,589,2012-2,7,22,3,19,3
589,589,2013-1,7,22,0,22,6
590,590,2010-1,6,21,21,0,17
590,590,2010-2,6,21,21,0,17
590,590,2011-1,6,22,22,0,16
590,590,2011-2,6,22,22,0,16
590,590,2011-3,6,22,22,0,16
590,590,2012-1,6,21,21,0,16
590,590,2012-2,6,22,22,0,17
590,590,2013-1,6,22,22,0,17
590,590,2013-2,6,22,22,0,16
590,590,2013-3,7,21,21,0,16
591,591,2010-1,7,22,22,0,16
591,591,2010-2,7,22,22,0,15
591,591,2010-C,3,9,9,0,17
591,591,2011-1,7,22,22,0,15
591,591,2011-2,6,20,20,0,15
591,591,2011-3,5,20,20,0,16
591,591,2012-1,5,15,15,0,14
591,591,2012-2,7,22,16,6,14
591,591,2013-2,7,22,22,0,15
591,591,2013-3,7,22,22,0,15
591,591,2014-1,4,13,10,3,13
591,591,2014-2,3,9,3,6,7
591,591,2015-1,3,9,0,9,0
591,591,2015-2,4,12,12,0,14
592,592,2010-1,6,21,21,0,15
592,592,2010-2,6,21,21,0,15
592,592,2010-C,3,11,11,0,16
592,592,2011-1,6,21,21,0,15
592,592,2011-2,6,22,22,0,16
592,592,2011-3,6,21,21,0,15
592,592,2012-1,6,21,21,0,14
592,592,2012-2,6,22,15,7,14
592,592,2013-1,3,11,11,0,14
592,592,2013-2,6,22,7,15,12
592,592,2013-3,4,15,0,15,6
592,592,2014-1,4,15,8,7,9
592,592,2014-2,3,11,0,11,3
593,593,2012-2,7,22,19,3,15
593,593,2013-1,7,22,19,3,16
593,593,2013-2,5,15,12,3,15
593,593,2013-3,6,19,16,3,14
593,593,2014-1,5,16,0,16,1
594,594,2010-1,7,22,18,4,13
594,594,2010-2,6,19,7,12,8
594,594,2010-C,3,10,3,7,11
594,594,2011-1,4,14,7,7,13
595,595,2010-1,6,21,21,0,15
595,595,2010-2,6,21,17,4,14
595,595,2011-1,6,22,0,22,0
596,596,2010-1,3,11,8,3,10
597,597,2012-1,5,15,5,10,5
598,598,2010-1,7,22,17,5,12
598,598,2010-2,7,21,6,15,4
598,598,2010-C,3,9,9,0,14
599,599,2010-1,6,21,0,21,0
600,600,2010-1,6,21,17,4,14
600,600,2010-2,6,22,10,12,10
600,600,2010-C,3,11,11,0,15
600,600,2011-1,6,21,21,0,15
600,600,2011-3,6,22,15,7,13
602,602,2010-1,7,22,0,22,0
603,603,2010-1,7,22,19,3,12
603,603,2010-C,3,9,3,6,5
603,603,2011-1,7,22,0,22,0
603,603,2011-3,7,22,0,22,0
603,603,2012-2,7,22,0,22,2
603,603,2013-2,6,19,0,19,2
604,604,2010-1,6,21,18,3,14
604,604,2010-2,6,21,21,0,16
604,604,2010-C,2,8,8,0,17
604,604,2011-1,6,21,21,0,17
604,604,2011-2,6,22,22,0,17
604,604,2011-3,6,22,22,0,16
604,604,2012-1,7,22,22,0,17
604,604,2012-2,6,22,22,0,16
604,604,2013-1,6,22,22,0,16
604,604,2013-2,6,22,22,0,17
604,604,2013-3,5,16,16,0,16
605,605,2010-1,6,21,0,21,10
606,606,2010-1,6,21,0,21,3
606,606,2013-1,6,18,13,5,14
606,606,2013-2,6,16,3,13,9
607,607,2010-1,6,21,14,7,13
607,607,2010-2,6,21,17,4,14
607,607,2010-C,2,8,8,0,14
607,607,2011-1,6,22,18,4,13
607,607,2011-2,6,21,21,0,15
607,607,2011-3,6,22,14,8,13
607,607,2012-1,6,21,12,9,8
607,607,2012-2,6,20,7,13,13
607,607,2013-1,6,20,13,7,13
607,607,2013-2,6,22,10,12,11
607,607,2013-3,6,22,8,14,12
607,607,2014-1,5,20,4,16,10
607,607,2014-2,6,22,14,8,13
607,607,2015-1,6,22,18,4,14
607,607,2015-2,6,22,15,7,13
608,608,2010-1,6,21,21,0,15
608,608,2010-2,6,21,21,0,16
608,608,2011-1,6,22,18,4,14
608,608,2011-2,6,21,21,0,16
608,608,2011-3,6,22,22,0,14
608,608,2012-1,7,22,19,3,14
608,608,2012-2,6,21,17,4,14
608,608,2013-1,5,18,14,4,14
608,608,2013-3,5,19,15,4,13
608,608,2014-1,4,15,12,3,15
608,608,2014-2,5,18,11,7,13
608,608,2015-1,4,15,15,0,15
608,608,2015-2,2,7,7,0,15
609,609,2010-1,6,21,21,0,15
609,609,2010-2,6,21,21,0,16
609,609,2010-C,3,11,11,0,16
609,609,2011-1,6,21,21,0,15
610,610,2010-1,7,22,22,0,15
610,610,2010-2,7,22,10,12,13
610,610,2010-C,3,11,11,0,15
610,610,2011-1,7,21,21,0,16
610,610,2011-2,6,22,22,0,15
610,610,2011-3,6,20,11,9,12
610,610,2012-1,6,20,20,0,15
610,610,2012-2,4,15,7,8,14
610,610,2013-1,6,22,22,0,15
610,610,2013-2,4,15,15,0,15
610,610,2013-3,6,22,22,0,15
610,610,2014-1,6,21,21,0,15
610,610,2014-2,4,13,13,0,16
611,611,2010-1,6,21,0,21,6
611,611,2010-C,3,11,0,11,9
611,611,2011-1,6,21,13,8,13
611,611,2011-2,6,21,3,18,9
611,611,2011-3,7,22,11,11,11
611,611,2012-1,6,20,7,13,9
611,611,2012-2,4,14,10,4,14
611,611,2014-1,4,12,8,4,12
611,611,2014-2,3,11,11,0,16
611,611,2015-1,4,15,11,4,13
611,611,2015-2,3,11,7,4,14
612,612,2010-1,6,21,17,4,14
612,612,2010-2,6,21,17,4,13
612,612,2011-1,6,22,15,7,12
612,612,2011-2,6,22,15,7,10
612,612,2011-3,6,22,15,7,12
612,612,2012-1,6,22,12,10,12
612,612,2012-2,4,15,7,8,10
613,613,2013-1,6,18,4,14,10
614,614,2010-1,6,21,14,7,13
614,614,2010-C,3,11,8,3,13
614,614,2011-1,6,21,13,8,13
614,614,2011-2,6,20,16,4,14
614,614,2011-3,6,21,18,3,12
614,614,2012-1,6,21,13,8,13
614,614,2012-2,5,20,8,12,11
614,614,2013-1,5,20,20,0,15
614,614,2013-2,5,19,19,0,14
614,614,2013-3,5,17,14,3,13
614,614,2014-1,6,21,8,13,11
614,614,2014-2,5,18,8,10,14
614,614,2015-1,4,14,11,3,11
614,614,2015-2,5,18,14,4,14
615,615,2010-1,6,21,21,0,16
615,615,2010-2,6,21,21,0,17
615,615,2010-C,3,11,11,0,17
615,615,2011-1,6,21,21,0,17
615,615,2011-2,6,22,22,0,18
615,615,2011-3,6,21,21,0,17
615,615,2012-1,6,21,21,0,17
615,615,2012-2,6,22,22,0,16
615,615,2013-1,5,19,19,0,16
615,615,2013-2,6,22,22,0,16
615,615,2013-3,5,15,15,0,15
616,616,2010-1,6,20,20,0,19
616,616,2010-2,7,25,25,0,18
616,616,2010-C,2,7,7,0,16
616,616,2011-1,4,13,13,0,17
616,616,2011-2,5,19,19,0,17
616,616,2011-3,6,22,22,0,17
616,616,2012-1,4,14,14,0,17
616,616,2012-2,6,22,22,0,16
616,616,2013-1,5,20,20,0,16
616,616,2013-2,4,12,12,0,16
617,617,2010-1,6,21,11,10,13
617,617,2010-C,2,8,8,0,14
618,618,2010-1,6,21,4,17,6
619,619,2010-1,6,21,21,0,17
619,619,2010-2,6,21,21,0,16
619,619,2010-C,3,11,11,0,17
619,619,2011-1,6,21,21,0,16
619,619,2011-2,6,22,22,0,17
619,619,2011-3,6,21,21,0,16
619,619,2012-1,6,21,21,0,16
619,619,2012-2,6,22,22,0,17
619,619,2013-1,5,19,19,0,17
619,619,2013-2,6,22,22,0,16
619,619,2013-3,5,15,15,0,16
620,620,2010-1,6,21,18,3,14
620,620,2010-2,6,21,17,4,14
620,620,2010-C,3,11,11,0,15
620,620,2011-1,6,21,17,4,12
620,620,2011-2,6,22,14,8,13
620,620,2011-3,6,22,0,22,6
620,620,2012-1,6,22,14,8,13
620,620,2012-2,6,22,8,14,10
620,620,2013-1,5,18,7,11,12
620,620,2013-2,5,17,7,10,9
620,620,2013-3,6,19,9,10,10
620,620,2014-1,4,14,8,6,11
620,620,2014-2,6,21,14,7,13
621,621,2010-1,6,21,21,0,16
621,621,2010-2,6,21,21,0,16
621,621,2010-C,3,11,11,0,17
621,621,2012-1,6,20,17,3,16
621,621,2012-2,6,22,22,0,17
621,621,2013-1,6,22,22,0,17
621,621,2013-2,6,21,21,0,15
621,621,2013-3,6,22,22,0,16
621,621,2014-1,5,19,19,0,16
621,621,2014-2,6,22,22,0,16
621,621,2015-1,7,21,21,0,16
622,622,2010-1,6,21,0,21,3
623,623,2010-1,6,21,0,21,0
624,624,2010-1,6,21,21,0,15
624,624,2010-2,6,21,21,0,16
624,624,2010-C,3,11,11,0,15
624,624,2011-1,7,22,18,4,15
624,624,2011-2,6,22,18,4,16
624,624,2011-3,5,19,19,0,14
624,624,2012-1,6,20,20,0,15
624,624,2012-2,6,21,21,0,15
624,624,2013-1,5,20,16,4,14
624,624,2013-2,6,22,19,3,14
624,624,2013-3,6,22,22,0,16
624,624,2014-1,3,10,6,4,14
624,624,2014-2,1,4,4,0,14
625,625,2010-1,6,21,18,3,14
625,625,2010-2,6,21,21,0,14
625,625,2011-1,6,22,14,8,13
625,625,2011-2,6,21,17,4,15
625,625,2011-3,6,22,18,4,13
625,625,2012-1,5,19,19,0,15
625,625,2012-2,6,21,21,0,15
625,625,2013-1,6,22,22,0,16
625,625,2013-2,6,22,22,0,15
625,625,2013-3,6,22,22,0,17
625,625,2014-1,7,22,22,0,16
627,627,2010-1,6,21,0,21,3
628,628,2010-1,6,21,0,21,7
629,629,2010-1,6,21,8,13,5
629,629,2010-2,6,21,10,11,9
629,629,2011-1,6,21,11,10,8
629,629,2011-2,6,21,18,3,13
629,629,2011-3,6,21,11,10,7
629,629,2012-1,6,21,14,7,10
629,629,2012-2,6,21,17,4,12
629,629,2013-1,6,22,7,15,10
629,629,2013-2,5,19,0,19,4
629,629,2014-2,4,15,11,4,12
630,630,2010-1,6,21,11,10,10
630,630,2010-2,5,18,8,10,9
630,630,2010-C,3,12,0,12,0
630,630,2011-1,6,22,4,18,3
631,631,2010-1,6,21,21,0,17
631,631,2010-2,6,21,21,0,17
631,631,2010-C,3,11,11,0,17
631,631,2011-1,6,21,21,0,16
631,631,2011-2,6,22,22,0,17
631,631,2011-3,6,21,21,0,17
631,631,2012-1,6,21,21,0,16
631,631,2012-2,6,22,22,0,17
631,631,2013-1,5,19,19,0,17
631,631,2013-2,6,22,22,0,17
631,631,2013-3,5,15,15,0,16
632,632,2010-1,6,21,21,0,16
632,632,2010-2,6,21,21,0,16
632,632,2011-1,4,13,13,0,16
632,632,2011-2,6,20,20,0,16
632,632,2011-3,6,22,22,0,15
632,632,2012-1,6,22,7,15,10
633,633,2010-1,6,21,11,10,11
633,633,2010-2,4,14,11,3,13
633,633,2010-C,2,8,8,0,15
633,633,2011-1,6,21,14,7,11
633,633,2011-2,4,15,7,8,8
633,633,2011-3,6,19,15,4,12
633,633,2012-1,6,21,17,4,13
633,633,2012-2,6,21,8,13,13
633,633,2013-1,4,15,15,0,14
633,633,2013-2,6,20,7,13,8
633,633,2013-3,6,20,13,7,13
633,633,2014-1,4,14,11,3,14
633,633,2014-2,4,15,11,4,12
633,633,2015-1,4,15,15,0,14
633,633,2015-2,6,22,15,7,13
634,634,2010-1,6,21,21,0,16
634,634,2010-2,6,21,21,0,17
634,634,2010-C,3,11,11,0,17
634,634,2011-1,6,21,21,0,16
634,634,2011-2,6,22,22,0,17
634,634,2011-3,6,21,21,0,17
634,634,2012-1,6,21,21,0,16
634,634,2012-2,6,22,22,0,17
634,634,2013-1,5,19,19,0,17
634,634,2013-2,6,22,22,0,16
634,634,2013-3,5,15,15,0,16
635,635,2010-1,7,22,15,7,13
635,635,2010-C,3,10,3,7,11
636,636,2010-1,7,22,12,10,8
636,636,2010-2,7,21,21,0,18
636,636,2010-C,3,11,11,0,17
636,636,2011-1,7,23,23,0,16
636,636,2011-2,6,22,18,4,15
636,636,2011-3,5,19,11,8,15
636,636,2012-1,4,16,12,4,12
636,636,2012-2,6,22,14,8,12
636,636,2013-1,6,22,14,8,15
636,636,2013-2,4,15,7,8,11
636,636,2014-1,6,22,19,3,15
636,636,2015-1,5,16,12,4,14
637,637,2010-1,7,22,6,16,7
637,637,2010-2,6,19,4,15,3
637,637,2010-C,2,7,4,3,9
637,637,2011-1,5,16,0,16,0
637,637,2011-2,7,21,0,21,1
637,637,2011-3,4,11,3,8,4
638,638,2010-1,7,22,22,0,17
638,638,2010-2,7,22,22,0,15
638,638,2010-C,3,11,11,0,16
638,638,2011-1,7,22,22,0,15
638,638,2011-2,6,22,14,8,14
638,638,2011-3,4,15,15,0,16
638,638,2012-1,5,19,19,0,16
638,638,2012-2,5,18,14,4,15
638,638,2013-1,6,22,22,0,16
638,638,2013-2,6,22,22,0,16
638,638,2013-3,6,22,22,0,16
638,638,2014-1,4,12,12,0,16
639,639,2010-1,6,21,21,0,16
639,639,2010-2,6,21,21,0,16
639,639,2010-C,3,11,11,0,17
639,639,2011-1,6,21,17,4,16
639,639,2011-2,6,21,21,0,16
639,639,2011-3,6,21,21,0,17
639,639,2012-1,6,19,16,3,15
639,639,2012-2,5,18,18,0,15
639,639,2013-1,6,22,22,0,15
639,639,2013-2,4,16,8,8,10
639,639,2013-3,3,12,12,0,15
639,639,2014-1,5,19,19,0,16
639,639,2014-2,4,12,12,0,15
640,640,2010-1,6,21,17,4,16
640,640,2010-2,6,21,17,4,15
640,640,2010-C,3,11,11,0,16
640,640,2011-1,6,22,18,4,12
640,640,2011-2,6,21,21,0,16
640,640,2011-3,6,22,19,3,14
640,640,2012-1,7,22,22,0,15
640,640,2012-2,5,18,14,4,15
640,640,2013-1,4,15,15,0,14
640,640,2013-2,4,15,11,4,12
640,640,2013-3,4,15,15,0,16
640,640,2014-1,6,22,22,0,15
640,640,2014-2,4,14,8,6,12
640,640,2015-1,3,9,6,3,13
641,641,2010-1,7,22,22,0,17
641,641,2010-2,7,22,22,0,15
641,641,2010-C,3,11,11,0,16
641,641,2011-1,7,22,18,4,15
641,641,2011-2,6,22,15,7,13
641,641,2011-3,6,22,15,7,15
641,641,2012-1,6,22,22,0,15
641,641,2012-2,4,14,7,7,14
641,641,2013-1,6,21,21,0,16
641,641,2013-2,5,20,20,0,16
641,641,2013-3,6,21,21,0,16
641,641,2014-1,5,17,17,0,17
641,641,2014-2,2,6,6,0,17
642,642,2010-1,6,20,16,4,15
642,642,2010-2,6,21,21,0,17
642,642,2011-1,6,20,20,0,15
642,642,2011-3,6,22,19,3,14
642,642,2012-1,6,21,17,4,14
642,642,2012-2,5,17,4,13,10
643,643,2010-1,6,21,17,4,14
643,643,2010-2,6,21,14,7,14
643,643,2010-C,3,11,11,0,15
643,643,2011-1,6,22,18,4,12
643,643,2011-2,6,22,18,4,15
643,643,2011-3,6,22,16,6,13
643,643,2012-1,7,22,19,3,14
643,643,2012-2,6,21,17,4,14
643,643,2013-1,6,21,15,6,14
643,643,2013-2,6,21,14,7,12
643,643,2013-3,5,18,18,0,14
643,643,2014-1,6,21,14,7,15
643,643,2014-2,5,18,15,3,14
643,643,2015-1,4,13,13,0,15
644,644,2010-1,6,21,14,7,14
644,644,2010-2,6,21,21,0,16
644,644,2010-C,2,8,8,0,15
644,644,2011-1,6,22,22,0,15
644,644,2011-2,6,21,21,0,15
644,644,2011-3,6,22,22,0,14
644,644,2012-1,6,21,18,3,14
644,644,2012-2,6,22,4,18,10
644,644,2013-1,6,21,18,3,14
644,644,2013-2,6,21,10,11,12
644,644,2013-3,5,19,12,7,13
644,644,2014-1,4,14,14,0,15
644,644,2014-2,6,20,2,18,8
644,644,2015-1,5,18,11,7,11
645,645,2010-1,7,22,22,0,16
645,645,2010-2,6,21,21,0,17
645,645,2010-C,2,7,4,3,13
645,645,2011-1,6,20,4,16,5
645,645,2011-2,5,17,9,8,9
645,645,2011-3,5,19,0,19,3
646,646,2010-1,6,21,13,8,13
646,646,2010-2,6,21,18,3,14
646,646,2010-C,3,11,8,3,12
646,646,2011-1,6,22,4,18,3
646,646,2012-1,6,21,17,4,11
646,646,2012-2,6,21,21,0,15
646,646,2013-1,6,22,22,0,16
646,646,2013-2,5,18,8,10,11
646,646,2013-3,6,21,14,7,13
646,646,2014-1,5,18,0,18,4
646,646,2014-2,5,18,4,14,8
646,646,2015-1,5,19,7,12,7
646,646,2015-2,6,21,0,21,0
647,647,2010-1,6,21,21,0,15
647,647,2010-2,6,21,21,0,17
647,647,2011-1,6,22,22,0,16
647,647,2011-2,6,22,22,0,16
647,647,2011-3,6,22,22,0,15
647,647,2012-1,6,21,21,0,16
647,647,2012-2,6,22,22,0,16
647,647,2013-1,6,22,22,0,17
647,647,2013-2,6,22,22,0,16
647,647,2013-3,7,21,21,0,16
648,648,2010-1,7,22,19,3,14
648,648,2010-2,7,22,16,6,11
648,648,2010-C,3,9,9,0,16
649,649,2010-1,6,21,21,0,16
649,649,2010-2,6,21,21,0,17
649,649,2011-1,6,22,18,4,16
649,649,2011-2,5,20,20,0,15
649,649,2011-3,6,22,22,0,15
649,649,2012-1,6,21,21,0,16
649,649,2012-2,6,22,22,0,16
649,649,2013-1,6,22,22,0,16
649,649,2013-2,6,22,22,0,14
649,649,2013-3,7,21,21,0,15
649,649,2015-1,2,6,6,0,15
650,650,2010-1,6,21,18,3,12
650,650,2010-2,6,21,14,7,11
650,650,2011-1,6,22,11,11,12
650,650,2011-2,6,22,0,22,0
651,651,2010-1,6,21,21,0,16
651,651,2010-2,6,22,18,4,12
651,651,2010-C,3,11,11,0,16
652,652,2010-1,6,21,13,8,13
652,652,2010-2,6,21,21,0,15
652,652,2011-1,6,21,21,0,15
652,652,2011-2,6,22,18,4,12
652,652,2011-3,6,21,19,2,15
652,652,2012-1,6,21,13,8,14
652,652,2012-2,4,15,15,0,16
652,652,2013-1,6,22,14,8,14
652,652,2013-2,4,15,15,0,16
652,652,2013-3,4,15,11,4,12
652,652,2014-1,6,22,18,4,14
652,652,2014-2,4,15,11,4,14
652,652,2015-2,4,15,8,7,11
653,653,2010-1,6,21,21,0,16
653,653,2010-2,6,22,22,0,15
653,653,2010-C,3,11,11,0,17
653,653,2011-1,6,21,21,0,16
653,653,2011-2,6,22,22,0,15
653,653,2011-3,6,22,22,0,15
653,653,2012-1,6,22,22,0,16
653,653,2012-2,6,22,22,0,16
653,653,2013-1,6,22,22,0,16
653,653,2013-2,7,22,22,0,16
653,653,2013-3,3,9,9,0,16
654,654,2010-1,7,22,0,22,1
655,655,2010-1,6,21,0,21,1
656,656,2010-1,6,21,18,3,14
656,656,2015-1,6,19,16,3,13
656,656,2015-2,7,20,13,7,14
657,657,2010-1,7,22,18,4,12
657,657,2010-2,6,19,11,8,10
657,657,2010-C,3,10,6,4,12
657,657,2011-1,2,6,0,6,11
657,657,2011-2,5,17,0,17,8
657,657,2011-3,4,13,0,13,10
658,658,2010-1,7,22,14,8,12
658,658,2010-2,6,20,9,11,11
658,658,2010-C,3,10,6,4,13
658,658,2011-1,5,20,0,20,4
658,658,2011-2,3,12,4,8,9
658,658,2011-3,5,18,10,8,11
658,658,2012-1,5,17,17,0,14
658,658,2012-2,6,20,0,20,5
658,658,2013-1,4,14,0,14,3
658,658,2013-2,4,14,0,14,3
658,658,2013-3,6,21,4,17,3
658,658,2014-1,6,20,9,11,11
658,658,2014-2,5,19,8,11,9
658,658,2015-1,6,20,16,4,13
658,658,2015-2,5,19,11,8,11
659,659,2010-1,7,22,22,0,15
659,659,2010-2,7,22,10,12,12
659,659,2010-C,3,9,9,0,16
659,659,2011-1,7,22,0,22,0
659,659,2011-2,7,22,0,22,2
659,659,2012-1,7,22,16,6,13
659,659,2012-2,6,20,10,10,9
659,659,2013-1,6,21,12,9,10
659,659,2013-2,6,20,11,9,10
659,659,2013-3,7,22,0,22,2
659,659,2014-1,7,22,13,9,11
659,659,2014-2,7,22,13,9,11
659,659,2015-1,6,20,10,10,12
659,659,2015-2,6,19,13,6,11
660,660,2010-1,7,22,22,0,15
660,660,2010-2,7,22,15,7,12
660,660,2010-C,3,9,9,0,15
660,660,2011-1,7,22,15,7,12
660,660,2011-2,6,21,7,14,11
660,660,2011-3,3,11,11,0,15
660,660,2012-1,6,19,10,9,12
660,660,2012-2,4,13,4,9,12
661,661,2010-1,6,21,6,15,9
661,661,2010-2,7,22,9,13,11
661,661,2010-C,2,7,7,0,14
661,661,2011-1,5,17,12,5,14
661,661,2011-2,5,17,9,8,12
661,661,2011-3,5,17,12,5,11
661,661,2012-1,6,20,8,12,12
661,661,2012-2,7,22,14,8,12
661,661,2013-1,4,15,7,8,11
661,661,2013-2,6,22,18,4,13
661,661,2013-3,7,22,9,13,9
661,661,2014-1,7,21,9,12,12
661,661,2014-2,7,21,7,14,9
661,661,2015-2,7,21,14,7,13
662,662,2010-1,6,21,3,18,6
662,662,2010-2,7,22,0,22,0
662,662,2011-1,7,22,3,19,7
662,662,2011-2,6,21,3,18,4
662,662,2011-3,6,19,0,19,1
662,662,2012-1,6,19,0,19,0
662,662,2012-2,4,15,0,15,0
662,662,2013-1,6,19,0,19,0
662,662,2013-2,4,14,0,14,2
662,662,2013-3,5,17,0,17,0
662,662,2014-1,6,18,0,18,3
662,662,2014-2,6,18,6,12,6
662,662,2015-1,6,20,5,15,9
662,662,2015-2,4,15,7,8,10
663,663,2010-1,6,21,17,4,14
663,663,2010-2,6,22,3,19,10
663,663,2010-C,3,11,11,0,15
663,663,2011-1,6,20,3,17,8
663,663,2011-2,6,21,4,17,11
663,663,2011-3,5,19,4,15,11
663,663,2012-1,6,20,11,9,13
663,663,2012-2,6,21,0,21,7
663,663,2013-2,6,20,8,12,12
663,663,2013-3,7,19,7,12,11
663,663,2014-1,7,22,6,16,6
663,663,2014-2,7,20,14,6,12
663,663,2015-1,6,20,10,10,12
663,663,2015-2,6,20,13,7,11
664,664,2010-1,7,22,0,22,1
664,664,2010-C,2,6,4,2,13
664,664,2011-1,6,18,6,12,8
664,664,2011-2,6,18,0,18,5
664,664,2011-3,5,14,3,11,6
664,664,2012-1,7,21,3,18,3
664,664,2012-2,6,19,5,14,5
664,664,2013-1,6,19,3,16,6
664,664,2013-2,7,20,2,18,3
664,664,2013-3,6,19,0,19,1
665,665,2010-1,7,22,12,10,12
665,665,2010-2,7,22,16,6,12
665,665,2010-C,1,3,0,3,10
665,665,2011-1,7,22,6,16,8
665,665,2011-2,7,22,6,16,7
665,665,2011-3,7,22,0,22,0
665,665,2012-1,5,16,0,16,3
665,665,2012-2,6,19,6,13,10
665,665,2013-1,5,16,16,0,14
665,665,2013-2,6,19,3,16,9
665,665,2013-3,6,20,13,7,10
665,665,2014-1,4,14,14,0,15
665,665,2014-2,7,22,10,12,13
665,665,2015-1,6,21,8,13,8
665,665,2015-2,5,13,3,10,11
666,666,2010-1,6,21,10,11,12
666,666,2010-2,7,22,18,4,13
666,666,2010-C,3,11,3,8,13
666,666,2011-1,4,16,0,16,1
666,666,2011-2,4,16,0,16,10
666,666,2011-3,4,16,16,0,14
666,666,2012-1,6,21,17,4,13
666,666,2012-2,6,21,14,7,14
666,666,2013-1,7,22,19,3,14
666,666,2013-2,6,21,4,17,12
666,666,2013-3,7,21,18,3,14
666,666,2014-1,6,20,9,11,12
666,666,2014-2,6,20,10,10,13
666,666,2015-1,7,21,17,4,12
666,666,2015-2,6,22,4,18,8
667,667,2010-1,6,21,6,15,7
667,667,2010-2,7,22,11,11,11
667,667,2011-3,4,15,0,15,1
667,667,2012-2,4,15,12,3,12
667,667,2013-1,6,21,21,0,15
667,667,2013-2,6,21,0,21,4
667,667,2015-2,6,20,12,8,12
668,668,2010-1,7,22,22,0,15
668,668,2010-2,6,21,13,8,14
668,668,2010-C,3,11,4,7,12
668,668,2011-1,5,20,16,4,11
668,668,2011-2,6,22,15,7,13
668,668,2011-3,4,11,5,6,10
668,668,2012-1,7,22,10,12,10
668,668,2012-2,3,11,0,11,5
668,668,2013-1,3,11,7,4,14
668,668,2013-2,3,11,4,7,11
668,668,2013-3,3,11,7,4,11
668,668,2014-1,7,22,15,7,12
668,668,2014-2,7,21,4,17,11
668,668,2015-1,6,20,6,14,6
668,668,2015-2,3,11,11,0,14
669,669,2010-1,6,21,18,3,15
669,669,2010-2,5,17,17,0,16
669,669,2010-C,2,7,7,0,16
669,669,2011-1,6,22,22,0,15
669,669,2011-2,6,22,18,4,14
669,669,2011-3,6,22,22,0,15
669,669,2012-1,6,20,20,0,15
669,669,2012-2,6,22,19,3,15
669,669,2013-1,6,22,22,0,15
669,669,2013-2,6,21,21,0,14
669,669,2013-3,6,21,21,0,14
669,669,2014-1,3,9,9,0,16
670,670,2010-1,6,21,17,4,15
670,670,2010-2,6,21,21,0,15
670,670,2010-C,1,4,4,0,17
670,670,2011-1,6,22,22,0,15
670,670,2011-2,6,22,22,0,15
670,670,2011-3,6,22,22,0,14
670,670,2012-1,6,21,21,0,15
670,670,2012-2,6,22,16,6,14
670,670,2013-1,6,22,22,0,15
670,670,2013-2,6,22,8,14,11
670,670,2013-3,6,20,3,17,11
670,670,2014-1,5,17,9,8,13
670,670,2014-2,6,21,0,21,5
670,670,2015-1,6,21,0,21,7
670,670,2015-2,6,21,0,21,1
671,671,2010-1,7,22,12,10,9
671,671,2010-2,6,19,15,4,12
671,671,2010-C,2,6,2,4,5
671,671,2011-1,6,19,10,9,13
671,671,2011-2,5,16,6,10,8
671,671,2011-3,6,21,14,7,11
671,671,2012-1,6,20,13,7,10
671,671,2012-2,3,11,7,4,13
671,671,2013-1,5,20,12,8,11
671,671,2013-2,4,15,11,4,11
671,671,2013-3,5,19,15,4,14
671,671,2014-1,4,15,15,0,14
671,671,2014-2,6,22,22,0,15
671,671,2015-1,6,22,22,0,15
671,671,2015-2,6,22,22,0,14
672,672,2010-1,6,21,17,4,12
672,672,2010-2,6,21,10,11,11
672,672,2010-C,3,11,0,11,0
672,672,2011-1,6,22,3,19,5
672,672,2011-2,6,22,10,12,8
672,672,2011-3,4,15,0,15,1
672,672,2012-1,6,21,0,21,6
672,672,2012-2,6,22,14,8,11
672,672,2013-1,6,22,16,6,12
672,672,2013-3,4,14,0,14,6
672,672,2015-2,4,12,12,0,14
673,673,2010-1,6,21,21,0,15
673,673,2010-2,6,22,18,4,14
673,673,2010-C,3,11,11,0,16
673,673,2011-1,6,22,18,4,14
673,673,2011-2,6,22,14,8,13
673,673,2011-3,6,22,18,4,14
673,673,2012-1,6,22,22,0,15
673,673,2012-2,6,22,22,0,15
673,673,2013-1,6,22,22,0,15
673,673,2013-2,6,22,18,4,14
673,673,2013-3,7,22,15,7,14
673,673,2014-1,5,17,17,0,14
674,674,2010-1,6,21,21,0,16
674,674,2010-2,6,21,18,3,15
674,674,2011-1,6,21,13,8,11
674,674,2011-3,6,20,16,4,14
675,675,2010-1,6,21,17,4,15
675,675,2010-2,6,21,21,0,15
675,675,2011-1,6,22,18,4,14
675,675,2011-2,6,21,10,11,11
675,675,2011-3,6,21,7,14,13
675,675,2012-1,6,22,7,15,9
675,675,2012-2,5,18,0,18,3
675,675,2013-1,6,22,4,18,7
675,675,2013-2,6,22,15,7,10
675,675,2013-3,6,22,15,7,12
675,675,2014-1,6,22,15,7,13
675,675,2014-2,6,22,11,11,9
675,675,2015-1,5,20,16,4,13
675,675,2015-2,6,22,16,6,12
676,676,2010-1,6,21,21,0,15
676,676,2010-2,6,22,22,0,16
676,676,2010-C,3,12,12,0,17
676,676,2011-1,6,22,22,0,16
676,676,2011-2,6,22,22,0,17
676,676,2011-3,8,26,26,0,17
676,676,2012-1,6,22,22,0,16
676,676,2012-2,6,22,22,0,15
676,676,2013-1,6,22,22,0,16
676,676,2013-2,8,25,25,0,15
677,677,2010-1,6,21,21,0,15
677,677,2010-2,6,21,18,3,16
677,677,2010-C,3,11,7,4,15
677,677,2011-1,6,22,22,0,16
677,677,2011-2,6,22,22,0,15
677,677,2011-3,6,22,22,0,15
677,677,2012-1,6,22,18,4,14
677,677,2012-2,6,22,22,0,15
677,677,2013-1,6,22,22,0,15
677,677,2013-2,6,21,18,3,15
677,677,2013-3,8,24,24,0,15
678,678,2010-1,6,21,21,0,16
678,678,2010-2,7,22,22,0,16
678,678,2011-1,6,21,20,1,15
678,678,2011-2,7,22,22,0,15
678,678,2011-3,6,22,22,0,16
678,678,2012-1,7,22,12,10,14
678,678,2012-2,7,21,17,4,14
678,678,2013-1,7,22,18,4,15
678,678,2013-2,7,22,22,0,16
678,678,2013-3,6,22,22,0,15
678,678,2014-1,4,18,18,0,16
679,679,2010-1,6,21,21,0,16
679,679,2010-2,7,22,22,0,18
679,679,2010-C,3,11,8,3,15
679,679,2011-1,6,22,22,0,17
679,679,2011-2,6,22,22,0,17
679,679,2011-3,7,22,22,0,16
679,679,2012-1,7,21,21,0,16
679,679,2012-2,7,22,22,0,16
679,679,2013-1,7,22,22,0,15
679,679,2013-2,6,22,22,0,16
679,679,2013-3,3,12,12,0,16
680,680,2010-1,7,22,20,2,14
680,680,2010-2,6,18,13,5,13
680,680,2010-C,2,6,0,6,4
680,680,2011-1,7,21,11,10,8
680,680,2011-2,7,22,5,17,9
680,680,2011-3,6,20,10,10,8
680,680,2012-1,6,21,10,11,12
680,680,2012-2,4,14,10,4,14
680,680,2013-1,5,20,8,12,9
680,680,2013-2,5,19,15,4,15
680,680,2013-3,6,22,19,3,13
680,680,2014-1,6,22,18,4,15
680,680,2014-2,6,22,22,0,14
680,680,2015-1,6,22,19,3,15
680,680,2015-2,6,22,22,0,15
681,681,2010-1,7,22,22,0,15
681,681,2010-2,7,22,18,4,13
681,681,2010-C,3,11,11,0,15
681,681,2011-1,6,20,16,4,15
681,681,2011-2,6,20,17,3,15
681,681,2011-3,6,22,22,0,16
681,681,2012-1,6,22,18,4,15
681,681,2012-2,5,19,19,0,17
681,681,2013-1,7,26,26,0,16
681,681,2013-2,6,22,22,0,17
681,681,2013-3,6,18,15,3,14
681,681,2014-1,3,11,11,0,15
683,683,2010-1,6,21,6,15,10
683,683,2010-2,6,21,0,21,0
685,685,2010-1,6,21,21,0,16
685,685,2010-2,6,21,21,0,17
685,685,2011-1,6,22,22,0,17
685,685,2011-2,6,22,22,0,18
685,685,2011-3,6,22,22,0,17
685,685,2012-1,6,21,21,0,17
685,685,2012-2,6,22,22,0,17
685,685,2013-1,6,22,22,0,16
685,685,2013-2,6,22,22,0,17
685,685,2013-3,7,21,21,0,16
686,686,2010-1,7,22,22,0,15
686,686,2010-2,7,22,22,0,14
686,686,2010-C,3,11,11,0,16
686,686,2011-1,7,22,22,0,15
686,686,2011-2,6,22,14,8,14
686,686,2011-3,5,19,12,7,14
686,686,2012-1,3,11,11,0,15
686,686,2012-2,6,22,15,7,13
686,686,2013-1,6,22,22,0,16
686,686,2013-2,6,21,21,0,16
686,686,2013-3,5,20,20,0,16
686,686,2014-1,4,13,13,0,16
686,686,2014-2,4,12,12,0,16
